#,#,#,#,#,#,#,#,#,#,#,#,#,#,#,#,#,#,#,#,#,#,#,#,#,#,#,#,#,#,#
#,S,#,.,.,.,#,.,.,.,#,.,.,.,.,.,#,.,#,.,.,.,.,.,.,.,.,.,#,.,#
#,.,#,.,#,.,#,.,#,.,#,.,#,#,#,.,#,.,#,.,#,#,#,#,#,.,#,.,#,.,#
#,.,.,.,#,.,.,.,#,.,#,.,#,.,.,.,#,.,.,.,#,.,#,.,.,.,#,.,#,.,#
#,#,#,#,#,#,#,#,#,.,#,.,#,.,#,#,#,.,#,#,#,.,#,.,#,#,#,.,#,.,#
#,.,.,.,#,.,.,.,#,.,.,.,#,.,#,.,#,.,#,.,.,.,#,.,#,.,#,.,.,.,#
#,.,#,.,#,.,#,.,#,#,#,#,#,.,#,.,#,.,#,#,#,.,#,.,#,.,#,#,#,.,#
#,.,#,.,.,.,#,.,.,.,#,.,.,.,#,.,.,.,.,.,.,.,#,.,#,.,.,.,.,.,#
#,#,#,#,#,#,#,.,#,.,#,.,#,#,#,#,#,#,#,#,#,.,#,.,#,#,#,.,#,#,#
#,.,.,.,.,.,.,.,#,.,#,.,.,.,.,.,.,.,#,.,.,.,#,.,.,.,#,.,#,.,#
#,.,#,#,#,#,#,#,#,.,#,#,#,#,#,#,#,.,#,#,#,.,#,#,#,.,#,.,#,.,#
#,.,.,.,#,.,.,.,.,.,.,.,.,.,#,.,#,.,.,.,#,.,.,.,#,.,#,.,#,.,#
#,.,#,.,#,#,#,#,#,#,#,#,#,.,#,.,#,#,#,.,#,#,#,.,#,.,#,.,#,.,#
#,.,#,.,.,.,.,.,.,.,.,.,#,.,#,.,#,.,.,.,#,.,.,.,#,.,#,.,.,.,#
#,.,#,#,#,#,#,#,#,#,#,.,#,.,#,.,#,.,#,#,#,.,#,#,#,.,#,#,#,#,#
#,.,#,.,.,.,.,.,#,.,.,.,#,.,.,.,#,.,.,.,#,.,.,.,#,.,.,.,.,.,#
#,.,#,.,#,#,#,#,#,.,#,#,#,#,#,#,#,#,#,.,#,#,#,#,#,#,#,#,#,.,#
#,.,.,.,#,.,.,.,.,.,#,.,.,.,.,.,.,.,#,.,.,.,#,.,.,.,.,.,#,.,#
#,#,#,.,#,.,#,#,#,#,#,.,#,#,#,#,#,.,#,#,#,.,#,.,#,#,#,.,#,.,#
#,.,.,.,#,.,.,.,.,.,#,.,.,.,#,.,#,.,.,.,#,.,.,.,#,.,.,.,#,.,#
#,#,#,#,#,#,#,#,#,.,#,#,#,.,#,.,#,.,#,#,#,#,#,#,#,.,#,#,#,.,#
#,.,.,.,.,.,.,.,#,.,.,.,#,.,.,.,#,.,#,.,.,.,.,.,#,.,.,.,#,.,#
#,.,#,#,#,#,#,.,#,.,#,#,#,.,#,#,#,.,#,.,#,#,#,.,#,#,#,.,#,.,#
#,.,#,.,.,.,.,.,.,.,#,.,.,.,#,.,.,.,#,.,.,.,#,.,.,.,#,.,.,.,#
#,.,#,.,#,#,#,#,#,#,#,.,#,#,#,.,#,#,#,#,#,.,#,.,#,#,#,#,#,.,#
#,.,#,.,.,.,#,.,.,.,.,.,#,.,#,.,.,.,.,.,#,.,#,.,.,.,.,.,.,.,#
#,.,#,#,#,#,#,.,#,#,#,#,#,.,#,#,#,#,#,.,#,.,#,#,#,#,#,#,#,#,#
#,.,#,.,.,.,.,.,#,.,.,.,#,.,#,.,.,.,.,.,#,.,.,.,#,.,.,.,.,.,#
#,.,#,.,#,#,#,#,#,.,#,.,#,.,#,.,#,#,#,#,#,#,#,.,#,#,#,.,#,.,#
#,.,.,.,.,.,.,.,.,.,#,.,.,.,#,.,.,.,.,.,.,.,.,.,.,.,.,.,#,G,#
#,#,#,#,#,#,#,#,#,#,#,#,#,#,#,#,#,#,#,#,#,#,#,#,#,#,#,#,#,#,#
