#,#,#,#,#,#,#,#,#,#,#,#,#,#,#
#,S,.,.,#,.,.,.,.,.,.,.,#,.,#
#,#,#,.,#,.,#,#,#,.,#,.,#,.,#
#,.,.,.,#,.,#,.,.,.,#,.,.,.,#
#,.,#,#,#,#,#,.,#,#,#,#,#,.,#
#,.,.,.,.,.,.,.,#,.,.,.,#,.,#
#,#,#,#,#,#,#,#,#,#,#,.,#,.,#
#,.,.,.,.,.,.,.,.,.,#,.,#,.,#
#,.,#,#,#,#,#,#,#,.,#,.,#,.,#
#,.,#,.,.,.,.,.,.,.,.,.,#,.,#
#,.,#,#,#,#,#,#,#,.,#,#,#,.,#
#,.,.,.,#,.,.,.,#,.,#,.,.,.,#
#,.,#,.,#,.,#,.,#,#,#,.,#,#,#
#,.,#,.,.,.,#,.,.,.,.,.,.,G,#
#,#,#,#,#,#,#,#,#,#,#,#,#,#,#