#,#,#,#,#,#,#,#,#,#,#,#,#,#,#,#,#
#,S,#,.,.,.,.,.,.,.,.,.,.,.,.,.,#
#,.,#,.,#,#,#,#,#,#,#,.,#,#,#,.,#
#,.,#,.,.,.,#,.,#,.,.,.,#,.,#,.,#
#,.,#,#,#,.,#,.,#,.,#,#,#,.,#,.,#
#,.,.,.,#,.,#,.,#,.,#,.,#,.,.,.,#
#,#,#,.,#,.,#,.,#,.,#,.,#,.,#,#,#
#,.,.,.,#,.,.,.,#,.,#,.,.,.,#,.,#
#,.,#,#,#,#,#,.,#,.,#,#,#,.,#,.,#
#,.,#,.,.,.,#,.,#,.,.,.,#,.,.,.,#
#,.,#,.,#,.,#,#,#,.,#,.,#,#,#,.,#
#,.,.,.,#,.,.,.,#,.,#,.,#,.,#,.,#
#,#,#,#,#,#,#,.,#,#,#,.,#,.,#,.,#
#,.,.,.,.,.,#,.,.,.,#,.,#,.,#,.,#
#,.,#,#,#,.,#,#,#,.,#,.,#,.,#,.,#
#,.,.,.,#,.,.,.,.,.,.,.,#,.,.,G,#
#,#,#,#,#,#,#,#,#,#,#,#,#,#,#,#,#