#,#,#,#,#,#,#,#,#,#,#,#,#,#,#,#,#,#,#,#,#
#,S,.,.,#,.,.,.,.,.,.,.,.,.,#,.,.,.,.,.,#
#,#,#,.,#,.,#,.,#,#,#,#,#,.,#,#,#,.,#,.,#
#,.,#,.,#,.,#,.,#,.,.,.,#,.,.,.,.,.,#,.,#
#,.,#,.,#,#,#,.,#,#,#,.,#,#,#,#,#,#,#,.,#
#,.,#,.,.,.,#,.,#,.,.,.,.,.,.,.,#,.,.,.,#
#,.,#,#,#,.,#,.,#,.,#,#,#,#,#,#,#,.,#,#,#
#,.,.,.,#,.,.,.,#,.,#,.,.,.,.,.,#,.,#,.,#
#,.,#,#,#,#,#,#,#,.,#,.,#,#,#,.,#,.,#,.,#
#,.,.,.,.,.,.,.,.,.,#,.,.,.,#,.,#,.,.,.,#
#,#,#,#,#,.,#,#,#,.,#,.,#,#,#,.,#,#,#,.,#
#,.,.,.,.,.,#,.,#,.,#,.,#,.,.,.,#,.,.,.,#
#,.,#,#,#,#,#,.,#,.,#,.,#,.,#,#,#,.,#,#,#
#,.,#,.,.,.,#,.,.,.,#,.,#,.,.,.,.,.,#,.,#
#,.,#,.,#,#,#,.,#,#,#,.,#,#,#,#,#,#,#,.,#
#,.,#,.,.,.,.,.,#,.,#,.,.,.,.,.,#,.,.,.,#
#,.,#,#,#,#,#,.,#,.,#,#,#,#,#,.,#,#,#,.,#
#,.,.,.,.,.,#,.,.,.,#,.,.,.,#,.,.,.,#,.,#
#,.,#,#,#,.,#,#,#,#,#,.,#,.,#,#,#,.,#,.,#
#,.,.,.,#,.,.,.,.,.,.,.,#,.,.,.,.,.,.,G,#
#,#,#,#,#,#,#,#,#,#,#,#,#,#,#,#,#,#,#,#,#