#,#,#,#,#,#,#,#,#,#,#,#,#,#,#,#,#,#,#,#,#,#,#,#,#
#,S,.,.,#,.,.,.,.,.,.,.,#,.,.,.,.,.,.,.,.,.,.,.,#
#,#,#,.,#,.,#,#,#,#,#,.,#,.,#,#,#,#,#,.,#,#,#,.,#
#,.,.,.,#,.,.,.,.,.,#,.,.,.,#,.,.,.,#,.,#,.,.,.,#
#,.,#,#,#,#,#,#,#,.,#,#,#,#,#,.,#,#,#,.,#,.,#,#,#
#,.,.,.,.,.,#,.,.,.,#,.,.,.,#,.,.,.,#,.,#,.,.,.,#
#,#,#,#,#,.,#,.,#,#,#,.,#,.,#,#,#,.,#,.,#,#,#,.,#
#,.,.,.,.,.,#,.,#,.,.,.,#,.,.,.,.,.,#,.,#,.,.,.,#
#,.,#,#,#,#,#,.,#,.,#,#,#,#,#,#,#,.,#,.,#,#,#,.,#
#,.,.,.,.,.,#,.,.,.,#,.,.,.,.,.,.,.,#,.,.,.,#,.,#
#,#,#,#,#,.,#,#,#,#,#,.,#,#,#,#,#,#,#,#,#,.,#,#,#
#,.,.,.,#,.,.,.,#,.,.,.,#,.,.,.,.,.,.,.,#,.,.,.,#
#,.,#,.,#,#,#,.,#,.,#,#,#,.,#,.,#,#,#,#,#,#,#,.,#
#,.,#,.,.,.,.,.,#,.,#,.,.,.,#,.,.,.,.,.,.,.,#,.,#
#,.,#,#,#,#,#,#,#,.,#,#,#,#,#,#,#,#,#,#,#,.,#,.,#
#,.,.,.,#,.,.,.,#,.,.,.,.,.,.,.,#,.,.,.,.,.,#,.,#
#,#,#,.,#,.,#,.,#,#,#,#,#,#,#,.,#,.,#,#,#,.,#,.,#
#,.,#,.,.,.,#,.,#,.,.,.,.,.,.,.,.,.,#,.,#,.,#,.,#
#,.,#,#,#,#,#,.,#,#,#,#,#,#,#,#,#,#,#,.,#,.,#,.,#
#,.,.,.,#,.,.,.,#,.,.,.,#,.,.,.,#,.,.,.,.,.,#,.,#
#,.,#,#,#,.,#,#,#,.,#,.,#,.,#,.,#,#,#,#,#,#,#,.,#
#,.,#,.,.,.,#,.,.,.,#,.,.,.,#,.,#,.,.,.,.,.,.,.,#
#,.,#,.,#,#,#,#,#,.,#,#,#,#,#,.,#,.,#,#,#,#,#,.,#
#,.,.,.,.,.,.,.,.,.,#,.,.,.,.,.,.,.,#,.,.,.,.,G,#
#,#,#,#,#,#,#,#,#,#,#,#,#,#,#,#,#,#,#,#,#,#,#,#,#
