#,#,#,#,#,#,#,#,#,#,#,#,#,#,#,#,#,#,#,#,#,#,#,#,#,#,#,#,#,#,#,#,#,#,#,#,#,#,#,#,#,#,#,#,#
#,S,.,.,#,.,.,.,.,.,.,.,#,.,.,.,.,.,.,.,.,.,.,.,.,.,.,.,#,.,.,.,.,.,#,.,.,.,.,.,.,.,.,.,#
#,#,#,.,#,.,#,#,#,#,#,.,#,#,#,.,#,#,#,#,#,#,#,#,#,#,#,.,#,.,#,#,#,#,#,.,#,#,#,.,#,#,#,#,#
#,.,.,.,#,.,.,.,.,.,#,.,.,.,.,.,#,.,.,.,#,.,.,.,.,.,#,.,#,.,.,.,.,.,#,.,#,.,#,.,.,.,.,.,#
#,.,#,#,#,.,#,#,#,.,#,#,#,#,#,#,#,.,#,.,#,.,#,.,#,#,#,.,#,.,#,#,#,.,#,.,#,.,#,#,#,#,#,.,#
#,.,.,.,#,.,#,.,#,.,.,.,.,.,.,.,.,.,#,.,#,.,#,.,.,.,#,.,#,.,#,.,.,.,#,.,.,.,.,.,#,.,#,.,#
#,#,#,.,#,.,#,.,#,#,#,#,#,#,#,#,#,#,#,.,#,#,#,.,#,.,#,.,#,#,#,.,#,.,#,#,#,#,#,.,#,.,#,.,#
#,.,#,.,#,.,#,.,#,.,.,.,#,.,.,.,.,.,#,.,.,.,#,.,#,.,#,.,.,.,#,.,#,.,.,.,.,.,#,.,.,.,#,.,#
#,.,#,.,#,.,#,.,#,.,#,.,#,.,#,#,#,.,#,#,#,.,#,#,#,.,#,#,#,.,#,.,#,#,#,#,#,#,#,#,#,.,#,.,#
#,.,.,.,#,.,.,.,#,.,#,.,.,.,#,.,#,.,.,.,#,.,.,.,#,.,#,.,.,.,#,.,.,.,.,.,.,.,.,.,.,.,#,.,#
#,.,#,#,#,#,#,#,#,.,#,#,#,#,#,.,#,#,#,.,#,#,#,.,#,.,#,.,#,#,#,.,#,#,#,#,#,#,#,#,#,#,#,.,#
#,.,#,.,.,.,.,.,.,.,#,.,#,.,.,.,.,.,#,.,.,.,#,.,#,.,#,.,.,.,#,.,.,.,.,.,#,.,.,.,.,.,.,.,#
#,.,#,.,#,#,#,#,#,#,#,.,#,.,#,.,#,#,#,#,#,.,#,.,#,.,#,#,#,.,#,.,#,#,#,#,#,.,#,#,#,#,#,.,#
#,.,#,.,#,.,#,.,.,.,.,.,.,.,#,.,#,.,.,.,#,.,.,.,#,.,.,.,#,.,#,.,#,.,.,.,.,.,#,.,#,.,.,.,#
#,.,#,.,#,.,#,.,#,#,#,#,#,#,#,.,#,.,#,.,#,#,#,#,#,#,#,.,#,.,#,#,#,.,#,#,#,#,#,.,#,.,#,#,#
#,.,.,.,#,.,#,.,#,.,#,.,.,.,.,.,#,.,#,.,.,.,.,.,.,.,.,.,#,.,.,.,.,.,#,.,#,.,.,.,.,.,#,.,#
#,#,#,#,#,.,#,.,#,.,#,.,#,#,#,#,#,.,#,.,#,#,#,#,#,#,#,#,#,#,#,#,#,#,#,.,#,.,#,#,#,#,#,.,#
#,.,#,.,.,.,#,.,.,.,#,.,.,.,.,.,.,.,#,.,#,.,.,.,.,.,.,.,.,.,.,.,.,.,#,.,.,.,#,.,.,.,.,.,#
#,.,#,.,#,.,#,#,#,.,#,#,#,#,#,#,#,#,#,.,#,.,#,#,#,#,#,#,#,#,#,#,#,.,#,.,#,#,#,.,#,#,#,.,#
#,.,.,.,#,.,.,.,.,.,#,.,.,.,.,.,.,.,#,.,.,.,#,.,.,.,.,.,#,.,.,.,.,.,#,.,#,.,#,.,#,.,#,.,#
#,.,#,#,#,#,#,#,#,#,#,#,#,#,#,#,#,.,#,#,#,#,#,#,#,#,#,.,#,.,#,.,#,#,#,.,#,.,#,.,#,.,#,.,#
#,.,#,.,.,.,.,.,#,.,.,.,.,.,.,.,.,.,.,.,#,.,.,.,.,.,#,.,#,.,#,.,#,.,.,.,#,.,#,.,#,.,#,.,#
#,.,#,#,#,.,#,.,#,.,#,#,#,#,#,#,#,#,#,.,#,#,#,.,#,.,#,.,#,.,#,.,#,.,#,#,#,.,#,.,#,.,#,.,#
#,.,.,.,.,.,#,.,#,.,#,.,.,.,.,.,.,.,.,.,.,.,.,.,#,.,.,.,#,.,#,.,#,.,#,.,.,.,#,.,.,.,#,.,#
#,#,#,#,#,#,#,.,#,.,#,.,#,#,#,#,#,#,#,.,#,#,#,#,#,#,#,.,#,.,#,#,#,.,#,.,#,.,#,.,#,#,#,.,#
#,.,.,.,.,.,#,.,#,.,#,.,#,.,.,.,.,.,#,.,#,.,.,.,#,.,.,.,#,.,#,.,.,.,#,.,#,.,.,.,#,.,.,.,#
#,.,#,#,#,#,#,.,#,.,#,#,#,.,#,#,#,.,#,.,#,.,#,.,#,#,#,#,#,.,#,.,#,#,#,.,#,#,#,#,#,.,#,.,#
#,.,#,.,.,.,.,.,#,.,.,.,#,.,.,.,#,.,#,.,#,.,#,.,.,.,.,.,.,.,#,.,.,.,#,.,.,.,#,.,#,.,#,.,#
#,.,#,.,#,#,#,#,#,#,#,.,#,#,#,.,#,.,#,.,#,.,#,#,#,#,#,#,#,.,#,#,#,.,#,#,#,.,#,.,#,.,#,.,#
#,.,.,.,.,.,.,.,.,.,.,.,#,.,.,.,#,.,#,.,#,.,#,.,.,.,#,.,.,.,#,.,#,.,.,.,#,.,.,.,#,.,#,.,#
#,.,#,#,#,#,#,#,#,#,#,#,#,.,#,#,#,.,#,.,#,.,#,#,#,.,#,.,#,#,#,.,#,#,#,.,#,#,#,#,#,.,#,.,#
#,.,.,.,#,.,.,.,#,.,.,.,#,.,#,.,#,.,#,.,#,.,.,.,#,.,.,.,.,.,.,.,.,.,#,.,.,.,.,.,#,.,#,.,#
#,#,#,#,#,.,#,.,#,.,#,.,#,.,#,.,#,.,#,#,#,#,#,.,#,.,#,#,#,#,#,#,#,#,#,#,#,#,#,.,#,.,#,.,#
#,.,.,.,.,.,#,.,.,.,#,.,.,.,#,.,#,.,.,.,#,.,.,.,#,.,#,.,.,.,#,.,.,.,.,.,.,.,.,.,#,.,#,.,#
#,.,#,#,#,#,#,#,#,#,#,#,#,#,#,.,#,#,#,.,#,.,#,#,#,#,#,.,#,.,#,.,#,#,#,#,#,#,#,#,#,.,#,.,#
#,.,.,.,#,.,.,.,.,.,.,.,.,.,.,.,#,.,.,.,#,.,#,.,.,.,.,.,#,.,.,.,#,.,.,.,#,.,.,.,.,.,#,.,#
#,#,#,.,#,.,#,#,#,#,#,#,#,#,#,#,#,.,#,#,#,.,#,.,#,#,#,#,#,#,#,#,#,.,#,.,#,.,#,#,#,.,#,.,#
#,.,.,.,#,.,.,.,.,.,.,.,.,.,.,.,.,.,.,.,.,.,#,.,#,.,.,.,.,.,.,.,.,.,#,.,.,.,#,.,#,.,#,.,#
#,.,#,#,#,.,#,#,#,#,#,#,#,#,#,#,#,#,#,#,#,#,#,.,#,.,#,#,#,#,#,#,#,#,#,.,#,#,#,.,#,.,#,.,#
#,.,#,.,#,.,#,.,.,.,.,.,.,.,#,.,.,.,.,.,.,.,.,.,#,.,.,.,#,.,.,.,.,.,#,.,.,.,.,.,#,.,#,.,#
#,.,#,.,#,.,#,#,#,#,#,#,#,.,#,.,#,#,#,#,#,#,#,#,#,.,#,#,#,.,#,#,#,.,#,#,#,.,#,#,#,.,#,.,#
#,.,#,.,.,.,.,.,.,.,.,.,.,.,#,.,.,.,#,.,.,.,#,.,.,.,#,.,.,.,#,.,.,.,#,.,.,.,#,.,.,.,#,.,#
#,.,#,#,#,#,#,#,#,#,#,#,#,#,#,#,#,.,#,.,#,.,#,#,#,#,#,.,#,#,#,.,#,#,#,#,#,#,#,.,#,#,#,.,#
#,.,.,.,.,.,.,.,.,.,.,.,.,.,.,.,.,.,.,.,#,.,.,.,.,.,.,.,#,.,.,.,.,.,.,.,.,.,.,.,#,.,.,G,#
#,#,#,#,#,#,#,#,#,#,#,#,#,#,#,#,#,#,#,#,#,#,#,#,#,#,#,#,#,#,#,#,#,#,#,#,#,#,#,#,#,#,#,#,#
