#,#,#,#,#,#,#
#,S,.,.,#,.,#
#,#,#,.,#,.,#
#,.,.,.,#,.,#
#,.,#,#,#,.,#
#,.,.,.,.,G,#
#,#,#,#,#,#,#