#,#,#,#,#,#,#,#,#,#,#,#,#,#,#,#,#,#,#,#,#,#,#,#,#,#,#,#,#,#,#,#,#,#,#,#,#,#,#,#,#,#,#,#,#,#,#,#,#,#,#,#,#,#,#,#,#,#,#,#,#,#,#,#,#,#,#,#,#,#,#,#,#,#,#,#,#,#,#,#,#,#,#,#,#,#,#,#,#,#,#,#,#,#,#,#,#,#,#,#,#
#,S,.,.,.,.,.,.,#,.,.,.,.,.,.,.,#,.,.,.,.,.,.,.,.,.,.,.,#,.,.,.,.,.,.,.,.,.,.,.,.,.,.,.,.,.,.,.,#,.,.,.,#,.,#,.,.,.,.,.,.,.,.,.,.,.,#,.,.,.,.,.,#,.,.,.,.,.,.,.,#,.,.,.,.,.,.,.,#,.,.,.,.,.,.,.,.,.,#,.,#
#,#,#,#,#,#,#,.,#,.,#,#,#,#,#,.,#,.,#,#,#,#,#,#,#,.,#,.,#,.,#,#,#,#,#,#,#,.,#,#,#,#,#,#,#,#,#,.,#,.,#,.,#,.,#,.,#,#,#,#,#,#,#,.,#,.,#,#,#,.,#,#,#,.,#,.,#,#,#,#,#,.,#,#,#,.,#,#,#,.,#,#,#,#,#,.,#,.,#,.,#
#,.,#,.,.,.,.,.,#,.,.,.,#,.,.,.,#,.,.,.,.,.,#,.,.,.,#,.,#,.,.,.,#,.,.,.,.,.,#,.,.,.,.,.,.,.,#,.,#,.,#,.,#,.,#,.,#,.,.,.,#,.,.,.,#,.,.,.,.,.,#,.,.,.,#,.,.,.,#,.,.,.,#,.,#,.,.,.,.,.,#,.,.,.,.,.,#,.,.,.,#
#,.,#,.,#,#,#,#,#,#,#,.,#,.,#,#,#,#,#,.,#,#,#,.,#,#,#,.,#,.,#,#,#,.,#,#,#,#,#,.,#,#,#,#,#,.,#,.,#,.,#,.,#,.,#,.,#,#,#,.,#,.,#,.,#,#,#,#,#,#,#,.,#,#,#,#,#,.,#,.,#,#,#,.,#,#,#,#,#,#,#,.,#,#,#,#,#,#,#,.,#
#,.,#,.,#,.,.,.,#,.,.,.,#,.,#,.,.,.,.,.,#,.,.,.,#,.,.,.,#,.,#,.,.,.,#,.,.,.,.,.,.,.,#,.,.,.,#,.,#,.,#,.,#,.,.,.,.,.,.,.,#,.,#,.,#,.,.,.,#,.,.,.,.,.,.,.,#,.,#,.,#,.,.,.,.,.,#,.,.,.,.,.,#,.,.,.,#,.,.,.,#
#,.,#,.,#,.,#,.,#,#,#,#,#,.,#,.,#,#,#,#,#,.,#,.,#,#,#,#,#,.,#,.,#,#,#,#,#,#,#,.,#,#,#,.,#,.,#,.,#,.,#,.,#,#,#,#,#,#,#,.,#,.,#,#,#,.,#,.,#,.,#,#,#,#,#,#,#,.,#,.,#,#,#,.,#,.,#,.,#,#,#,#,#,.,#,.,#,.,#,#,#
#,.,#,.,.,.,#,.,#,.,.,.,#,.,.,.,.,.,.,.,#,.,#,.,#,.,.,.,#,.,#,.,.,.,.,.,.,.,#,.,#,.,.,.,#,.,#,.,.,.,#,.,.,.,.,.,.,.,#,.,#,.,.,.,#,.,#,.,#,.,#,.,.,.,.,.,.,.,#,.,.,.,#,.,#,.,#,.,#,.,.,.,#,.,#,.,#,.,.,.,#
#,.,#,#,#,#,#,.,#,.,#,.,#,#,#,#,#,#,#,#,#,.,#,#,#,.,#,.,#,.,#,#,#,#,#,#,#,.,#,.,#,.,#,#,#,#,#,#,#,#,#,#,#,#,#,#,#,.,#,#,#,.,#,.,#,.,#,.,#,.,#,.,#,#,#,#,#,#,#,#,#,.,#,#,#,.,#,.,#,.,#,.,#,.,#,.,#,#,#,.,#
#,.,#,.,.,.,#,.,.,.,#,.,.,.,.,.,.,.,.,.,#,.,#,.,.,.,#,.,.,.,#,.,.,.,.,.,#,.,#,.,#,.,.,.,.,.,#,.,.,.,.,.,.,.,.,.,#,.,.,.,#,.,#,.,.,.,#,.,.,.,#,.,.,.,.,.,#,.,.,.,.,.,#,.,.,.,#,.,.,.,#,.,#,.,#,.,#,.,#,.,#
#,.,#,.,#,.,#,#,#,#,#,#,#,#,#,#,#,#,#,.,#,.,#,.,#,#,#,#,#,#,#,.,#,#,#,.,#,.,#,#,#,#,#,.,#,.,#,.,#,#,#,.,#,#,#,#,#,#,#,.,#,.,#,#,#,#,#,#,#,.,#,#,#,#,#,.,#,.,#,#,#,#,#,.,#,.,#,#,#,#,#,.,#,.,#,.,#,.,#,.,#
#,.,.,.,#,.,.,.,.,.,#,.,.,.,.,.,#,.,#,.,#,.,#,.,#,.,.,.,.,.,#,.,#,.,.,.,#,.,.,.,.,.,#,.,#,.,.,.,#,.,#,.,#,.,.,.,.,.,.,.,#,.,.,.,#,.,.,.,#,.,.,.,.,.,#,.,#,.,#,.,.,.,.,.,#,.,#,.,.,.,#,.,.,.,#,.,#,.,#,.,#
#,.,#,#,#,#,#,#,#,.,#,.,#,.,#,.,#,.,#,.,#,.,#,.,#,.,#,.,#,#,#,.,#,.,#,#,#,.,#,#,#,.,#,.,#,#,#,#,#,.,#,.,#,.,#,#,#,#,#,#,#,#,#,#,#,.,#,.,#,#,#,#,#,.,#,.,#,.,#,.,#,#,#,.,#,.,#,.,#,.,#,#,#,#,#,.,#,.,#,.,#
#,.,.,.,.,.,#,.,#,.,.,.,#,.,#,.,#,.,#,.,#,.,.,.,.,.,#,.,#,.,.,.,#,.,#,.,.,.,#,.,.,.,#,.,#,.,.,.,#,.,#,.,#,.,.,.,#,.,.,.,.,.,.,.,.,.,#,.,.,.,.,.,#,.,#,.,#,.,#,.,#,.,.,.,#,.,#,.,#,.,#,.,.,.,#,.,#,.,#,.,#
#,#,#,#,#,.,#,.,#,#,#,#,#,.,#,.,#,.,#,.,#,#,#,#,#,#,#,#,#,.,#,#,#,.,#,#,#,#,#,.,#,#,#,.,#,.,#,.,#,.,#,.,#,#,#,.,#,.,#,#,#,#,#,#,#,#,#,#,#,#,#,.,#,.,#,.,#,.,#,#,#,.,#,#,#,.,#,.,#,#,#,.,#,.,#,.,#,.,#,.,#
#,.,.,.,#,.,.,.,#,.,.,.,.,.,#,.,#,.,#,.,.,.,.,.,.,.,.,.,.,.,#,.,#,.,.,.,.,.,#,.,#,.,.,.,#,.,#,.,.,.,#,.,#,.,.,.,#,.,.,.,#,.,.,.,#,.,#,.,.,.,#,.,#,.,#,.,#,.,.,.,.,.,#,.,#,.,.,.,#,.,.,.,#,.,.,.,#,.,.,.,#
#,.,#,.,#,#,#,#,#,.,#,#,#,#,#,.,#,.,#,#,#,#,#,#,#,#,#,#,#,#,#,.,#,#,#,#,#,.,#,.,#,.,#,#,#,.,#,#,#,.,#,.,#,.,#,#,#,#,#,.,#,.,#,.,#,.,#,.,#,.,#,.,#,#,#,.,#,#,#,#,#,#,#,.,#,#,#,.,#,.,#,#,#,#,#,#,#,.,#,#,#
#,.,#,.,.,.,.,.,#,.,#,.,.,.,#,.,#,.,.,.,.,.,.,.,#,.,.,.,.,.,#,.,.,.,#,.,#,.,.,.,#,.,#,.,.,.,.,.,#,.,#,.,#,.,.,.,#,.,.,.,#,.,#,.,.,.,#,.,#,.,.,.,.,.,.,.,.,.,#,.,#,.,.,.,.,.,.,.,#,.,#,.,.,.,.,.,#,.,#,.,#
#,.,#,#,#,#,#,.,#,.,#,.,#,.,#,.,#,#,#,#,#,.,#,#,#,.,#,.,#,.,#,.,#,.,#,.,#,#,#,#,#,.,#,#,#,#,#,.,#,.,#,.,#,#,#,.,#,.,#,#,#,.,#,#,#,#,#,.,#,#,#,#,#,#,#,#,#,.,#,.,#,.,#,#,#,#,#,#,#,.,#,.,#,#,#,.,#,.,#,.,#
#,.,.,.,.,.,#,.,.,.,#,.,#,.,.,.,.,.,.,.,.,.,#,.,.,.,#,.,#,.,.,.,#,.,#,.,.,.,.,.,#,.,.,.,.,.,.,.,#,.,#,.,.,.,.,.,#,.,#,.,.,.,.,.,.,.,.,.,#,.,#,.,.,.,.,.,#,.,.,.,#,.,.,.,#,.,.,.,.,.,#,.,.,.,#,.,.,.,#,.,#
#,.,#,#,#,.,#,#,#,.,#,#,#,#,#,#,#,#,#,.,#,#,#,.,#,#,#,.,#,#,#,#,#,.,#,#,#,#,#,.,#,#,#,#,#,#,#,#,#,.,#,#,#,#,#,#,#,.,#,#,#,#,#,.,#,#,#,#,#,.,#,.,#,#,#,.,#,#,#,#,#,#,#,.,#,.,#,#,#,#,#,#,#,.,#,#,#,#,#,.,#
#,.,#,.,#,.,#,.,.,.,#,.,.,.,.,.,.,.,#,.,#,.,.,.,#,.,#,.,.,.,#,.,#,.,.,.,.,.,.,.,#,.,.,.,.,.,#,.,#,.,.,.,.,.,#,.,.,.,.,.,.,.,#,.,.,.,.,.,.,.,#,.,.,.,#,.,.,.,.,.,.,.,.,.,#,.,#,.,.,.,.,.,#,.,.,.,#,.,.,.,#
#,.,#,.,#,.,#,#,#,#,#,.,#,#,#,#,#,.,#,.,#,.,#,#,#,.,#,#,#,.,#,.,#,#,#,#,#,#,#,.,#,.,#,#,#,.,#,.,#,#,#,#,#,.,#,#,#,.,#,#,#,.,#,#,#,#,#,#,#,#,#,#,#,.,#,#,#,#,#,#,#,#,#,#,#,.,#,.,#,#,#,.,#,#,#,.,#,.,#,.,#
#,.,.,.,#,.,.,.,.,.,.,.,#,.,.,.,#,.,#,.,#,.,#,.,.,.,#,.,.,.,#,.,.,.,.,.,.,.,#,.,#,.,.,.,#,.,.,.,.,.,.,.,#,.,.,.,#,.,.,.,#,.,.,.,.,.,.,.,.,.,.,.,.,.,.,.,#,.,.,.,.,.,.,.,#,.,#,.,.,.,#,.,.,.,#,.,.,.,#,.,#
#,#,#,.,#,#,#,#,#,#,#,#,#,#,#,.,#,.,#,#,#,.,#,.,#,.,#,.,#,#,#,#,#,#,#,.,#,.,#,.,#,#,#,.,#,#,#,#,#,#,#,#,#,#,#,.,#,#,#,.,#,#,#,#,#,#,#,#,#,#,#,#,#,#,#,.,#,#,#,.,#,#,#,#,#,.,#,#,#,.,#,.,#,.,#,#,#,#,#,.,#
#,.,#,.,.,.,.,.,.,.,.,.,.,.,#,.,#,.,.,.,.,.,#,.,#,.,#,.,.,.,.,.,#,.,.,.,#,.,#,.,.,.,#,.,#,.,.,.,.,.,.,.,.,.,#,.,.,.,#,.,#,.,.,.,.,.,.,.,.,.,.,.,.,.,#,.,.,.,#,.,#,.,.,.,.,.,#,.,#,.,#,.,#,.,.,.,.,.,#,.,#
#,.,#,#,#,#,#,#,#,#,#,#,#,.,#,.,#,#,#,#,#,#,#,#,#,.,#,#,#,#,#,.,#,.,#,#,#,#,#,#,#,.,#,.,#,.,#,#,#,#,#,.,#,#,#,#,#,.,#,.,#,.,#,#,#,#,#,#,#,#,#,#,#,.,#,#,#,.,#,.,#,.,#,#,#,#,#,.,#,.,#,.,#,#,#,#,#,#,#,.,#
#,.,.,.,.,.,#,.,.,.,.,.,#,.,#,.,.,.,.,.,.,.,.,.,.,.,.,.,.,.,#,.,#,.,.,.,#,.,.,.,.,.,#,.,#,.,.,.,.,.,#,.,.,.,.,.,#,.,#,.,#,.,#,.,.,.,.,.,#,.,.,.,#,.,#,.,#,.,#,.,#,.,.,.,#,.,.,.,#,.,#,.,#,.,.,.,#,.,.,.,#
#,.,#,#,#,#,#,.,#,.,#,.,#,.,#,.,#,#,#,#,#,#,#,#,#,#,#,#,#,.,#,.,#,#,#,.,#,.,#,#,#,#,#,.,#,#,#,#,#,.,#,#,#,.,#,#,#,.,#,.,#,.,#,.,#,#,#,.,#,.,#,.,#,.,#,.,#,.,#,.,#,#,#,.,#,#,#,.,#,.,#,.,#,.,#,.,#,.,#,#,#
#,.,#,.,.,.,.,.,#,.,#,.,#,.,#,.,.,.,#,.,.,.,#,.,.,.,.,.,.,.,#,.,.,.,#,.,.,.,.,.,.,.,.,.,#,.,.,.,.,.,#,.,.,.,#,.,.,.,#,.,#,.,#,.,#,.,.,.,#,.,#,.,.,.,#,.,.,.,#,.,.,.,#,.,.,.,#,.,.,.,#,.,.,.,#,.,#,.,.,.,#
#,.,#,.,#,#,#,#,#,.,#,.,#,.,#,#,#,.,#,.,#,#,#,.,#,#,#,#,#,#,#,#,#,.,#,#,#,#,#,#,#,.,#,#,#,.,#,#,#,#,#,.,#,#,#,.,#,#,#,.,#,.,#,.,#,.,#,#,#,.,#,#,#,#,#,#,#,.,#,.,#,.,#,#,#,.,#,#,#,#,#,#,#,#,#,.,#,#,#,.,#
#,.,.,.,#,.,.,.,#,.,#,.,#,.,#,.,.,.,#,.,#,.,.,.,#,.,.,.,.,.,#,.,#,.,.,.,.,.,#,.,#,.,#,.,.,.,#,.,.,.,#,.,.,.,.,.,#,.,.,.,#,.,#,.,#,.,.,.,#,.,.,.,#,.,.,.,#,.,#,.,#,.,#,.,#,.,.,.,.,.,.,.,.,.,#,.,.,.,#,.,#
#,.,#,#,#,.,#,.,#,.,#,#,#,.,#,.,#,#,#,.,#,.,#,#,#,#,#,.,#,.,#,.,#,#,#,#,#,.,#,.,#,.,#,.,#,#,#,.,#,.,#,#,#,#,#,#,#,.,#,#,#,.,#,#,#,#,#,.,#,#,#,.,#,.,#,.,#,.,#,.,#,.,#,.,#,#,#,#,#,#,#,#,#,.,#,#,#,.,#,.,#
#,.,.,.,#,.,#,.,#,.,#,.,.,.,#,.,#,.,.,.,#,.,#,.,.,.,.,.,#,.,#,.,.,.,.,.,#,.,#,.,.,.,#,.,#,.,.,.,#,.,.,.,.,.,#,.,.,.,#,.,#,.,.,.,.,.,#,.,.,.,#,.,.,.,#,.,#,.,.,.,#,.,.,.,.,.,.,.,#,.,.,.,#,.,.,.,#,.,#,.,#
#,#,#,#,#,.,#,.,#,.,#,.,#,#,#,.,#,.,#,#,#,.,#,.,#,#,#,#,#,.,#,#,#,.,#,.,#,.,#,.,#,#,#,.,#,#,#,.,#,#,#,.,#,#,#,.,#,#,#,.,#,#,#,#,#,.,#,#,#,.,#,#,#,#,#,.,#,#,#,#,#,#,#,#,#,#,#,.,#,#,#,.,#,#,#,.,#,.,#,.,#
#,.,.,.,#,.,#,.,#,.,#,.,.,.,#,.,#,.,.,.,.,.,#,.,#,.,.,.,.,.,.,.,.,.,#,.,#,.,#,.,.,.,#,.,.,.,#,.,.,.,#,.,.,.,#,.,#,.,.,.,.,.,.,.,#,.,#,.,.,.,.,.,#,.,#,.,.,.,.,.,.,.,.,.,.,.,#,.,#,.,.,.,.,.,#,.,#,.,.,.,#
#,.,#,.,#,.,#,.,#,.,#,#,#,.,#,.,#,#,#,#,#,.,#,.,#,#,#,#,#,#,#,#,#,#,#,#,#,.,#,#,#,#,#,#,#,.,#,#,#,.,#,#,#,.,#,.,#,.,#,#,#,#,#,#,#,.,#,.,#,#,#,.,#,.,#,#,#,#,#,#,#,#,#,#,#,.,#,.,#,.,#,#,#,#,#,.,#,#,#,.,#
#,.,#,.,.,.,#,.,.,.,.,.,#,.,#,.,.,.,.,.,#,.,#,.,.,.,.,.,.,.,.,.,.,.,#,.,.,.,#,.,.,.,.,.,#,.,.,.,#,.,#,.,#,.,.,.,#,.,#,.,.,.,.,.,.,.,#,.,#,.,.,.,.,.,.,.,.,.,.,.,.,.,.,.,#,.,#,.,.,.,#,.,.,.,#,.,.,.,#,.,#
#,.,#,#,#,#,#,.,#,#,#,#,#,.,#,.,#,#,#,.,#,.,#,#,#,#,#,.,#,#,#,#,#,.,#,.,#,#,#,.,#,#,#,.,#,#,#,.,#,.,#,.,#,#,#,#,#,.,#,.,#,#,#,#,#,#,#,.,#,#,#,#,#,#,#,.,#,#,#,#,#,#,#,#,#,.,#,#,#,#,#,.,#,.,#,#,#,.,#,.,#
#,.,.,.,#,.,#,.,#,.,.,.,.,.,#,.,.,.,#,.,#,.,.,.,.,.,#,.,.,.,.,.,#,.,#,.,.,.,.,.,#,.,#,.,.,.,#,.,#,.,.,.,.,.,.,.,.,.,#,.,.,.,.,.,#,.,.,.,.,.,.,.,.,.,#,.,#,.,.,.,.,.,.,.,#,.,.,.,#,.,.,.,#,.,.,.,.,.,#,.,#
#,#,#,.,#,.,#,.,#,.,#,#,#,#,#,#,#,#,#,.,#,#,#,#,#,.,#,.,#,#,#,#,#,.,#,#,#,#,#,#,#,.,#,.,#,#,#,.,#,#,#,.,#,#,#,#,#,#,#,#,#,#,#,.,#,#,#,.,#,#,#,#,#,.,#,.,#,.,#,#,#,#,#,.,#,#,#,.,#,.,#,.,#,#,#,#,#,#,#,.,#
#,.,.,.,#,.,.,.,#,.,.,.,.,.,.,.,.,.,.,.,#,.,.,.,#,.,#,.,#,.,.,.,.,.,#,.,.,.,.,.,.,.,#,.,.,.,.,.,#,.,.,.,#,.,.,.,.,.,.,.,.,.,#,.,.,.,#,.,.,.,.,.,#,.,#,.,#,.,.,.,#,.,#,.,.,.,.,.,#,.,#,.,#,.,.,.,#,.,.,.,#
#,.,#,#,#,#,#,#,#,#,#,#,#,#,#,#,#,#,#,#,#,.,#,.,#,.,#,#,#,.,#,#,#,.,#,.,#,.,#,#,#,#,#,#,#,#,#,#,#,#,#,#,#,.,#,#,#,#,#,#,#,.,#,.,#,.,#,#,#,#,#,#,#,.,#,#,#,#,#,.,#,.,#,#,#,#,#,#,#,.,#,.,#,.,#,.,#,#,#,.,#
#,.,.,.,.,.,.,.,.,.,#,.,.,.,#,.,.,.,.,.,#,.,#,.,#,.,.,.,#,.,#,.,.,.,.,.,#,.,#,.,.,.,.,.,#,.,.,.,.,.,.,.,.,.,#,.,.,.,.,.,#,.,#,.,#,.,.,.,.,.,.,.,#,.,#,.,.,.,#,.,.,.,.,.,#,.,.,.,.,.,#,.,#,.,#,.,.,.,#,.,#
#,.,#,#,#,#,#,.,#,.,#,.,#,.,#,.,#,#,#,.,#,#,#,.,#,#,#,.,#,.,#,#,#,#,#,#,#,#,#,.,#,.,#,#,#,.,#,#,#,.,#,#,#,#,#,.,#,.,#,.,#,.,#,#,#,#,#,#,#,#,#,.,#,.,#,.,#,.,#,#,#,#,#,.,#,#,#,#,#,.,#,#,#,.,#,#,#,.,#,.,#
#,.,#,.,#,.,.,.,#,.,.,.,#,.,.,.,#,.,.,.,#,.,.,.,.,.,#,.,#,.,#,.,.,.,.,.,.,.,.,.,#,.,#,.,.,.,#,.,#,.,.,.,#,.,.,.,#,.,#,.,#,.,.,.,.,.,#,.,.,.,.,.,#,.,#,.,#,.,.,.,.,.,#,.,.,.,.,.,#,.,.,.,.,.,#,.,.,.,#,.,#
#,.,#,.,#,.,#,#,#,#,#,#,#,#,#,#,#,.,#,#,#,.,#,#,#,.,#,.,#,.,#,.,#,#,#,#,#,#,#,#,#,.,#,.,#,#,#,.,#,#,#,.,#,.,#,#,#,.,#,#,#,#,#,#,#,.,#,.,#,#,#,#,#,.,#,.,#,#,#,.,#,#,#,#,#,#,#,.,#,.,#,#,#,#,#,.,#,#,#,#,#
#,.,.,.,#,.,.,.,.,.,.,.,#,.,#,.,.,.,#,.,.,.,#,.,#,.,#,.,#,.,.,.,#,.,.,.,.,.,#,.,.,.,#,.,#,.,.,.,.,.,#,.,#,.,.,.,#,.,.,.,.,.,#,.,.,.,#,.,.,.,#,.,#,.,.,.,.,.,#,.,.,.,.,.,.,.,#,.,#,.,#,.,.,.,#,.,.,.,.,.,#
#,#,#,.,#,#,#,#,#,#,#,.,#,.,#,.,#,#,#,.,#,#,#,.,#,.,#,.,#,.,#,#,#,.,#,.,#,#,#,.,#,#,#,.,#,.,#,#,#,.,#,.,#,#,#,.,#,#,#,#,#,.,#,.,#,#,#,.,#,.,#,.,#,.,#,#,#,#,#,#,#,#,#,#,#,.,#,.,#,.,#,#,#,.,#,#,#,#,#,.,#
#,.,.,.,#,.,.,.,.,.,.,.,#,.,.,.,#,.,.,.,#,.,.,.,.,.,#,.,#,.,.,.,#,.,#,.,.,.,#,.,.,.,.,.,#,.,.,.,#,.,#,.,.,.,#,.,.,.,.,.,#,.,.,.,#,.,.,.,#,.,#,.,.,.,#,.,#,.,.,.,.,.,#,.,.,.,#,.,#,.,.,.,.,.,#,.,.,.,.,.,#
#,.,#,#,#,.,#,#,#,#,#,#,#,.,#,#,#,.,#,#,#,.,#,#,#,#,#,.,#,#,#,.,#,.,#,#,#,.,#,#,#,#,#,#,#,#,#,#,#,.,#,#,#,.,#,#,#,#,#,.,#,#,#,#,#,#,#,#,#,.,#,.,#,#,#,.,#,.,#,#,#,.,#,.,#,.,#,.,#,#,#,#,#,.,#,.,#,#,#,.,#
#,.,.,.,#,.,.,.,#,.,.,.,#,.,#,.,.,.,#,.,#,.,#,.,.,.,.,.,#,.,.,.,#,.,.,.,#,.,.,.,.,.,.,.,.,.,.,.,.,.,.,.,#,.,.,.,#,.,#,.,.,.,.,.,.,.,.,.,#,.,#,.,.,.,#,.,#,.,#,.,#,.,.,.,#,.,#,.,.,.,#,.,.,.,#,.,.,.,#,.,#
#,#,#,#,#,#,#,.,#,.,#,#,#,.,#,.,#,#,#,.,#,.,#,.,#,#,#,#,#,.,#,#,#,.,#,#,#,#,#,#,#,.,#,#,#,#,#,#,#,#,#,.,#,#,#,.,#,.,#,#,#,#,#,#,#,#,#,.,#,.,#,#,#,.,#,.,#,.,#,.,#,#,#,.,#,#,#,#,#,.,#,#,#,.,#,#,#,.,#,#,#
#,.,.,.,.,.,.,.,#,.,.,.,#,.,.,.,#,.,.,.,.,.,#,.,#,.,.,.,#,.,#,.,.,.,#,.,.,.,.,.,.,.,#,.,.,.,.,.,.,.,#,.,#,.,.,.,#,.,.,.,#,.,.,.,.,.,.,.,#,.,#,.,.,.,.,.,#,.,#,.,#,.,.,.,#,.,.,.,#,.,.,.,#,.,#,.,#,.,.,.,#
#,.,#,#,#,#,#,#,#,.,#,.,#,#,#,#,#,.,#,#,#,#,#,.,#,.,#,#,#,.,#,.,#,#,#,.,#,#,#,#,#,#,#,.,#,.,#,#,#,.,#,.,#,.,#,#,#,.,#,.,#,.,#,#,#,#,#,#,#,.,#,#,#,#,#,.,#,.,#,.,#,.,#,#,#,.,#,.,#,#,#,.,#,.,#,.,#,#,#,.,#
#,.,#,.,.,.,.,.,#,.,#,.,#,.,.,.,#,.,#,.,#,.,.,.,#,.,.,.,.,.,#,.,.,.,#,.,.,.,#,.,.,.,.,.,#,.,.,.,#,.,#,.,#,.,.,.,#,.,#,.,.,.,#,.,.,.,.,.,.,.,.,.,#,.,.,.,#,.,#,.,#,.,#,.,.,.,#,.,.,.,.,.,#,.,.,.,#,.,.,.,#
#,.,#,.,#,#,#,.,#,#,#,.,#,.,#,.,#,.,#,.,#,.,#,#,#,.,#,#,#,#,#,.,#,#,#,#,#,.,#,.,#,#,#,#,#,#,#,.,#,#,#,.,#,#,#,.,#,.,#,#,#,#,#,.,#,#,#,#,#,#,#,.,#,#,#,#,#,.,#,.,#,.,#,.,#,#,#,#,#,#,#,#,#,#,#,.,#,.,#,.,#
#,.,.,.,#,.,#,.,.,.,#,.,.,.,#,.,#,.,#,.,#,.,.,.,#,.,.,.,.,.,#,.,#,.,.,.,.,.,#,.,#,.,.,.,.,.,#,.,.,.,#,.,#,.,.,.,#,.,.,.,#,.,#,.,#,.,.,.,#,.,#,.,#,.,.,.,.,.,#,.,#,.,#,.,.,.,#,.,.,.,#,.,.,.,#,.,#,.,#,.,#
#,.,#,#,#,.,#,#,#,.,#,.,#,#,#,.,#,.,#,.,#,#,#,.,#,#,#,#,#,.,#,#,#,.,#,#,#,#,#,.,#,#,#,#,#,.,#,#,#,.,#,.,#,.,#,#,#,#,#,.,#,.,#,.,#,.,#,.,#,.,#,.,#,.,#,#,#,#,#,.,#,.,#,#,#,.,#,.,#,.,#,.,#,.,#,.,#,.,#,.,#
#,.,#,.,.,.,.,.,#,.,#,.,.,.,#,.,.,.,#,.,.,.,#,.,.,.,.,.,#,.,.,.,.,.,#,.,.,.,.,.,.,.,.,.,.,.,.,.,#,.,.,.,#,.,#,.,.,.,.,.,#,.,.,.,#,.,#,.,#,.,#,.,#,.,.,.,.,.,#,.,.,.,#,.,.,.,#,.,#,.,.,.,#,.,#,.,#,.,#,.,#
#,.,#,.,#,#,#,.,#,.,#,#,#,#,#,.,#,#,#,.,#,#,#,#,#,#,#,.,#,#,#,#,#,#,#,#,#,#,#,#,#,#,#,#,#,.,#,#,#,#,#,#,#,.,#,.,#,#,#,#,#,.,#,#,#,.,#,.,#,.,#,.,#,.,#,#,#,.,#,#,#,#,#,.,#,#,#,.,#,#,#,#,#,.,#,#,#,.,#,.,#
#,.,#,.,#,.,.,.,#,.,.,.,.,.,#,.,.,.,#,.,.,.,.,.,.,.,#,.,.,.,#,.,.,.,.,.,#,.,.,.,.,.,#,.,.,.,#,.,.,.,#,.,.,.,#,.,#,.,.,.,.,.,.,.,.,.,#,.,.,.,#,.,#,.,#,.,#,.,.,.,.,.,.,.,#,.,.,.,.,.,.,.,#,.,#,.,.,.,#,.,#
#,.,#,.,#,.,#,#,#,#,#,#,#,.,#,#,#,.,#,#,#,#,#,.,#,#,#,#,#,.,#,.,#,#,#,.,#,.,#,#,#,.,#,.,#,#,#,.,#,.,#,.,#,#,#,.,#,.,#,#,#,#,#,#,#,#,#,#,#,.,#,.,#,.,#,.,#,#,#,#,#,#,#,#,#,.,#,#,#,#,#,.,#,.,#,.,#,#,#,.,#
#,.,#,.,#,.,.,.,#,.,.,.,.,.,#,.,#,.,#,.,.,.,#,.,.,.,.,.,#,.,.,.,#,.,#,.,#,.,#,.,.,.,#,.,.,.,#,.,#,.,.,.,#,.,#,.,#,.,#,.,.,.,.,.,.,.,.,.,#,.,#,.,#,.,.,.,.,.,#,.,.,.,.,.,.,.,.,.,.,.,#,.,#,.,.,.,#,.,#,.,#
#,.,#,#,#,#,#,.,#,.,#,#,#,#,#,.,#,.,#,.,#,.,#,#,#,.,#,.,#,#,#,#,#,.,#,.,#,.,#,.,#,#,#,#,#,#,#,.,#,#,#,#,#,.,#,.,#,#,#,.,#,#,#,#,#,#,#,.,#,#,#,.,#,#,#,#,#,.,#,.,#,#,#,#,#,#,#,#,#,#,#,.,#,#,#,#,#,.,#,.,#
#,.,.,.,.,.,.,.,#,.,.,.,#,.,.,.,#,.,#,.,#,.,.,.,#,.,#,.,.,.,.,.,.,.,#,.,#,.,#,.,.,.,#,.,.,.,.,.,#,.,.,.,.,.,.,.,#,.,.,.,#,.,.,.,.,.,#,.,#,.,.,.,#,.,.,.,.,.,#,.,.,.,#,.,.,.,.,.,.,.,#,.,#,.,.,.,.,.,#,.,#
#,#,#,#,#,.,#,#,#,#,#,.,#,.,#,.,#,.,#,.,#,#,#,.,#,#,#,#,#,.,#,#,#,.,#,.,#,.,#,#,#,.,#,.,#,#,#,#,#,.,#,#,#,#,#,#,#,.,#,#,#,#,#,.,#,.,#,.,#,.,#,#,#,.,#,#,#,#,#,#,#,.,#,.,#,#,#,#,#,.,#,.,#,.,#,#,#,#,#,.,#
#,.,.,.,#,.,#,.,.,.,.,.,#,.,#,.,#,.,.,.,#,.,#,.,.,.,.,.,.,.,#,.,.,.,#,.,.,.,#,.,#,.,.,.,#,.,#,.,.,.,#,.,.,.,.,.,.,.,#,.,.,.,.,.,#,.,#,.,.,.,#,.,#,.,#,.,.,.,.,.,.,.,#,.,#,.,.,.,#,.,.,.,#,.,.,.,.,.,.,.,#
#,.,#,.,#,.,#,.,#,#,#,#,#,.,#,.,#,#,#,#,#,.,#,#,#,#,#,#,#,#,#,.,#,#,#,#,#,#,#,.,#,#,#,#,#,.,#,.,#,#,#,#,#,.,#,#,#,#,#,#,#,.,#,#,#,.,#,#,#,#,#,.,#,.,#,#,#,.,#,#,#,#,#,.,#,.,#,#,#,#,#,#,#,.,#,#,#,#,#,#,#
#,.,#,.,.,.,#,.,#,.,.,.,.,.,#,.,#,.,.,.,.,.,.,.,.,.,#,.,.,.,#,.,#,.,.,.,.,.,#,.,.,.,.,.,.,.,#,.,.,.,#,.,.,.,#,.,.,.,.,.,.,.,#,.,.,.,.,.,.,.,.,.,#,.,.,.,#,.,.,.,#,.,.,.,#,.,.,.,.,.,.,.,.,.,#,.,.,.,.,.,#
#,.,#,#,#,#,#,.,#,.,#,.,#,#,#,#,#,.,#,#,#,#,#,.,#,#,#,.,#,.,#,.,#,#,#,#,#,.,#,.,#,.,#,#,#,#,#,#,#,.,#,.,#,#,#,.,#,#,#,.,#,#,#,#,#,#,#,.,#,#,#,#,#,#,#,.,#,#,#,.,#,.,#,#,#,#,#,#,#,.,#,#,#,#,#,#,#,.,#,.,#
#,.,#,.,.,.,.,.,#,.,#,.,.,.,#,.,.,.,#,.,.,.,#,.,.,.,.,.,#,.,#,.,#,.,.,.,#,.,#,.,#,.,.,.,.,.,.,.,.,.,#,.,#,.,.,.,.,.,#,.,.,.,.,.,#,.,.,.,#,.,.,.,.,.,.,.,#,.,.,.,#,.,.,.,.,.,.,.,#,.,.,.,.,.,.,.,#,.,#,.,#
#,.,#,.,#,#,#,#,#,#,#,#,#,.,#,.,#,#,#,.,#,.,#,#,#,#,#,#,#,.,#,.,#,.,#,.,#,.,#,.,#,#,#,#,#,#,#,#,#,#,#,.,#,.,#,#,#,#,#,#,#,#,#,.,#,.,#,#,#,.,#,#,#,#,#,#,#,.,#,#,#,#,#,#,#,#,#,.,#,#,#,#,#,#,#,.,#,.,#,.,#
#,.,#,.,.,.,.,.,.,.,.,.,#,.,.,.,#,.,.,.,#,.,#,.,.,.,.,.,#,.,#,.,#,.,#,.,.,.,#,.,.,.,.,.,#,.,.,.,.,.,.,.,#,.,#,.,.,.,.,.,.,.,#,.,#,.,.,.,#,.,.,.,#,.,.,.,.,.,#,.,.,.,.,.,.,.,.,.,#,.,.,.,.,.,#,.,#,.,#,.,#
#,.,#,#,#,#,#,#,#,#,#,.,#,.,#,#,#,.,#,#,#,.,#,#,#,.,#,.,#,.,#,.,#,.,#,#,#,.,#,#,#,#,#,.,#,#,#,.,#,#,#,#,#,.,#,.,#,#,#,#,#,.,#,.,#,#,#,.,#,#,#,.,#,.,#,#,#,#,#,.,#,#,#,#,#,#,#,#,#,.,#,#,#,#,#,.,#,.,#,#,#
#,.,#,.,#,.,.,.,.,.,.,.,#,.,.,.,.,.,#,.,#,.,.,.,#,.,#,.,#,.,.,.,#,.,.,.,#,.,.,.,.,.,#,.,#,.,.,.,#,.,.,.,#,.,#,.,#,.,.,.,.,.,#,.,#,.,.,.,#,.,#,.,#,.,.,.,.,.,#,.,#,.,.,.,.,.,.,.,.,.,#,.,.,.,.,.,#,.,.,.,#
#,.,#,.,#,.,#,#,#,#,#,.,#,#,#,#,#,#,#,.,#,#,#,.,#,#,#,.,#,#,#,#,#,.,#,.,#,#,#,#,#,.,#,.,#,.,#,#,#,#,#,.,#,.,#,.,#,.,#,#,#,#,#,.,#,.,#,#,#,.,#,.,#,#,#,#,#,#,#,.,#,#,#,#,#,.,#,.,#,#,#,.,#,#,#,#,#,#,#,.,#
#,.,.,.,#,.,.,.,#,.,.,.,#,.,.,.,#,.,.,.,.,.,#,.,.,.,#,.,.,.,.,.,.,.,#,.,#,.,.,.,#,.,#,.,.,.,#,.,.,.,#,.,#,.,#,.,#,.,.,.,#,.,.,.,#,.,.,.,.,.,#,.,.,.,.,.,.,.,.,.,#,.,.,.,#,.,#,.,#,.,.,.,#,.,.,.,.,.,#,.,#
#,#,#,.,#,#,#,.,#,#,#,#,#,.,#,.,#,#,#,#,#,.,#,#,#,.,#,#,#,#,#,#,#,#,#,.,#,.,#,.,#,#,#,#,#,#,#,.,#,.,#,.,#,.,#,.,#,#,#,.,#,#,#,.,#,#,#,#,#,.,#,#,#,#,#,#,#,#,#,#,#,.,#,.,#,.,#,.,#,.,#,#,#,.,#,#,#,.,#,.,#
#,.,#,.,.,.,#,.,.,.,.,.,#,.,#,.,.,.,.,.,#,.,.,.,#,.,.,.,.,.,.,.,.,.,.,.,#,.,#,.,.,.,.,.,.,.,.,.,#,.,.,.,#,.,#,.,.,.,#,.,.,.,#,.,#,.,.,.,#,.,#,.,.,.,.,.,#,.,#,.,.,.,#,.,.,.,#,.,#,.,#,.,.,.,#,.,#,.,.,.,#
#,.,#,#,#,.,#,#,#,#,#,.,#,.,#,#,#,#,#,.,#,.,#,#,#,#,#,#,#,#,#,#,#,#,#,.,#,.,#,#,#,#,#,#,#,.,#,#,#,#,#,.,#,.,#,#,#,.,#,#,#,.,#,.,#,.,#,#,#,.,#,#,#,.,#,.,#,.,#,.,#,.,#,#,#,#,#,.,#,.,#,.,#,#,#,.,#,#,#,.,#
#,.,.,.,#,.,#,.,.,.,#,.,#,.,#,.,.,.,#,.,#,.,.,.,#,.,.,.,.,.,.,.,.,.,.,.,#,.,#,.,.,.,#,.,.,.,#,.,.,.,#,.,#,.,.,.,#,.,#,.,.,.,#,.,#,.,.,.,.,.,.,.,.,.,#,.,.,.,#,.,#,.,#,.,.,.,.,.,#,.,#,.,#,.,.,.,#,.,.,.,#
#,.,#,#,#,.,#,.,#,#,#,.,#,.,#,#,#,.,#,.,#,#,#,.,#,.,#,#,#,#,#,#,#,#,#,#,#,.,#,#,#,.,#,.,#,#,#,.,#,.,#,#,#,.,#,#,#,.,#,.,#,#,#,.,#,.,#,#,#,#,#,#,#,#,#,#,#,.,#,.,#,.,#,#,#,#,#,.,#,.,#,.,#,.,#,.,#,.,#,#,#
#,.,#,.,.,.,.,.,#,.,.,.,#,.,.,.,.,.,#,.,.,.,#,.,.,.,#,.,.,.,#,.,.,.,.,.,#,.,.,.,.,.,#,.,.,.,.,.,#,.,#,.,.,.,#,.,.,.,#,.,#,.,.,.,#,.,#,.,.,.,#,.,.,.,.,.,#,.,#,.,#,.,.,.,.,.,#,.,#,.,#,.,#,.,#,.,.,.,.,.,#
#,.,#,.,#,#,#,#,#,.,#,#,#,#,#,#,#,.,#,#,#,.,#,.,#,#,#,.,#,.,#,.,#,#,#,.,#,#,#,#,#,.,#,#,#,#,#,#,#,.,#,.,#,#,#,.,#,#,#,.,#,.,#,#,#,#,#,.,#,.,#,.,#,#,#,.,#,.,#,.,#,#,#,#,#,.,#,#,#,.,#,.,#,#,#,#,#,#,#,#,#
#,.,.,.,#,.,.,.,#,.,.,.,.,.,.,.,#,.,#,.,#,.,#,.,#,.,.,.,#,.,#,.,.,.,#,.,.,.,.,.,.,.,#,.,.,.,.,.,#,.,.,.,#,.,#,.,.,.,#,.,.,.,#,.,.,.,.,.,#,.,.,.,#,.,#,.,#,.,#,.,.,.,#,.,#,.,.,.,.,.,#,.,.,.,.,.,.,.,.,.,#
#,#,#,#,#,.,#,.,#,#,#,#,#,.,#,#,#,.,#,.,#,.,#,#,#,.,#,#,#,.,#,#,#,.,#,#,#,#,#,#,#,#,#,.,#,#,#,#,#,#,#,#,#,.,#,#,#,.,#,#,#,.,#,.,#,#,#,#,#,#,#,#,#,.,#,.,#,#,#,#,#,.,#,.,#,#,#,#,#,#,#,.,#,#,#,#,#,.,#,.,#
#,.,.,.,.,.,#,.,.,.,.,.,.,.,#,.,.,.,#,.,#,.,.,.,.,.,#,.,.,.,.,.,#,.,.,.,#,.,.,.,.,.,#,.,.,.,#,.,.,.,#,.,.,.,.,.,#,.,.,.,#,.,#,.,#,.,.,.,#,.,.,.,.,.,#,.,.,.,.,.,.,.,#,.,.,.,.,.,.,.,#,.,#,.,.,.,#,.,#,.,#
#,.,#,#,#,#,#,#,#,#,#,.,#,#,#,.,#,#,#,.,#,#,#,#,#,#,#,.,#,#,#,#,#,#,#,.,#,.,#,#,#,#,#,.,#,.,#,.,#,.,#,.,#,.,#,.,#,#,#,.,#,.,#,.,#,.,#,.,#,.,#,#,#,.,#,#,#,#,#,#,#,#,#,#,#,.,#,#,#,.,#,#,#,.,#,.,#,#,#,.,#
#,.,#,.,.,.,.,.,.,.,#,.,#,.,.,.,#,.,.,.,#,.,.,.,.,.,#,.,.,.,.,.,.,.,.,.,#,.,.,.,.,.,.,.,#,.,.,.,#,.,.,.,#,.,#,.,.,.,#,.,#,.,#,.,#,.,#,.,#,.,#,.,#,.,#,.,#,.,.,.,.,.,.,.,.,.,#,.,#,.,#,.,.,.,#,.,.,.,.,.,#
#,.,#,.,#,#,#,#,#,.,#,#,#,.,#,#,#,.,#,.,#,.,#,#,#,.,#,#,#,#,#,#,#,#,#,#,#,.,#,#,#,#,#,#,#,#,#,#,#,#,#,.,#,.,#,#,#,#,#,.,#,#,#,.,#,.,#,.,#,.,#,.,#,.,#,.,#,.,#,.,#,#,#,#,#,#,#,.,#,.,#,.,#,#,#,#,#,#,#,.,#
#,.,#,.,#,.,.,.,.,.,#,.,.,.,#,.,.,.,#,.,.,.,#,.,#,.,#,.,#,.,.,.,.,.,.,.,#,.,.,.,#,.,#,.,.,.,#,.,.,.,#,.,#,.,.,.,.,.,#,.,.,.,.,.,#,.,#,.,#,.,#,.,#,.,#,.,.,.,#,.,#,.,.,.,.,.,#,.,#,.,.,.,#,.,.,.,#,.,.,.,#
#,.,#,.,#,.,#,#,#,#,#,.,#,#,#,#,#,.,#,#,#,#,#,.,#,.,#,.,#,.,#,#,#,.,#,.,#,#,#,.,#,.,#,.,#,.,#,.,#,.,#,#,#,.,#,#,#,.,#,#,#,#,#,#,#,.,#,.,#,.,#,.,#,.,#,.,#,#,#,.,#,.,#,#,#,.,#,.,#,#,#,#,#,.,#,.,#,.,#,#,#
#,.,#,.,#,.,.,.,.,.,#,.,.,.,.,.,.,.,#,.,.,.,.,.,#,.,#,.,.,.,#,.,#,.,#,.,#,.,.,.,#,.,#,.,#,.,#,.,#,.,.,.,#,.,.,.,#,.,.,.,.,.,.,.,.,.,#,.,.,.,#,.,.,.,#,.,#,.,.,.,#,.,#,.,.,.,#,.,.,.,#,.,.,.,#,.,#,.,#,.,#
#,.,#,.,#,#,#,#,#,.,#,#,#,#,#,#,#,#,#,.,#,.,#,#,#,.,#,.,#,#,#,.,#,.,#,#,#,.,#,#,#,.,#,.,#,.,#,.,#,#,#,.,#,#,#,#,#,.,#,#,#,.,#,#,#,#,#,#,#,#,#,.,#,#,#,.,#,.,#,#,#,.,#,.,#,#,#,#,#,.,#,.,#,#,#,.,#,.,#,.,#
#,.,#,.,.,.,.,.,#,.,#,.,.,.,#,.,.,.,.,.,#,.,.,.,.,.,#,.,#,.,.,.,#,.,.,.,.,.,.,.,.,.,#,.,#,.,#,.,.,.,#,.,.,.,.,.,#,.,#,.,.,.,#,.,#,.,.,.,.,.,.,.,#,.,.,.,#,.,.,.,.,.,#,.,.,.,#,.,.,.,#,.,.,.,#,.,.,.,#,.,#
#,.,#,#,#,#,#,.,#,.,#,.,#,.,#,.,#,#,#,#,#,#,#,#,#,#,#,.,#,.,#,.,#,#,#,#,#,.,#,#,#,#,#,.,#,.,#,.,#,.,#,#,#,#,#,.,#,#,#,.,#,#,#,.,#,.,#,#,#,#,#,#,#,#,#,#,#,#,#,#,#,#,#,#,#,.,#,.,#,.,#,#,#,.,#,#,#,#,#,.,#
#,.,.,.,.,.,.,.,#,.,.,.,#,.,#,.,#,.,.,.,.,.,.,.,#,.,.,.,.,.,#,.,#,.,.,.,#,.,#,.,.,.,#,.,#,.,#,.,#,.,.,.,.,.,#,.,.,.,.,.,#,.,#,.,.,.,#,.,.,.,.,.,.,.,.,.,#,.,.,.,.,.,#,.,.,.,#,.,#,.,.,.,#,.,#,.,.,.,.,.,#
#,.,#,#,#,#,#,#,#,#,#,#,#,.,#,.,#,.,#,#,#,#,#,.,#,#,#,#,#,#,#,#,#,.,#,.,#,#,#,.,#,.,#,.,#,.,#,#,#,#,#,#,#,.,#,#,#,#,#,#,#,.,#,.,#,#,#,.,#,#,#,#,#,#,#,.,#,.,#,#,#,.,#,.,#,#,#,.,#,#,#,#,#,.,#,.,#,#,#,.,#
#,.,.,.,.,.,.,.,.,.,.,.,#,.,.,.,.,.,#,.,.,.,.,.,.,.,.,.,.,.,.,.,.,.,#,.,.,.,.,.,#,.,.,.,#,.,.,.,.,.,.,.,.,.,#,.,.,.,.,.,.,.,.,.,.,.,.,.,#,.,.,.,.,.,.,.,.,.,#,.,.,.,.,.,#,.,.,.,.,.,.,.,.,.,.,.,#,.,.,G,#
#,#,#,#,#,#,#,#,#,#,#,#,#,#,#,#,#,#,#,#,#,#,#,#,#,#,#,#,#,#,#,#,#,#,#,#,#,#,#,#,#,#,#,#,#,#,#,#,#,#,#,#,#,#,#,#,#,#,#,#,#,#,#,#,#,#,#,#,#,#,#,#,#,#,#,#,#,#,#,#,#,#,#,#,#,#,#,#,#,#,#,#,#,#,#,#,#,#,#,#,#
