#,#,#,#,#,#,#
#,S,#,.,.,.,#
#,.,#,.,#,.,#
#,.,.,.,#,.,#
#,#,#,#,#,.,#
#,.,.,.,.,G,#
#,#,#,#,#,#,#
