#,#,#,#,#,#,#,#,#,#,#,#,#,#,#
#,S,.,.,#,.,.,.,.,.,.,.,#,.,#
#,#,.,.,#,.,#,#,#,.,#,.,#,.,#
#,.,#,.,#,.,#,.,.,.,#,.,#,.,#
#,.,.,.,#,.,#,.,#,#,#,.,.,.,#
#,.,.,.,#,.,#,.,.,.,#,.,.,.,#
#,.,#,#,#,.,.,#,#,.,#,#,#,.,#
#,.,.,.,#,.,.,.,#,.,.,.,#,.,#
#,#,#,.,#,#,#,#,#,#,.,.,#,.,#
#,.,#,.,.,.,.,.,.,.,.,.,#,.,#
#,.,#,#,#,#,#,#,#,#,#,#,#,.,#
#,.,.,.,.,.,#,.,.,.,.,.,.,.,#
#,.,.,#,#,#,#,.,#,#,#,#,#,#,#
#,.,.,.,.,.,.,.,.,.,.,.,.,G,#
#,#,#,#,#,#,#,#,#,#,#,#,#,#,#
