#,#,#,#,#,#,#,#,#,#,#,#,#
#,S,.,.,#,.,.,.,.,.,.,.,#
#,#,.,.,#,#,#,#,#,#,#,.,#
#,.,#,.,#,.,.,.,#,.,.,.,#
#,.,#,.,#,.,#,.,#,.,.,.,#
#,.,#,.,.,.,#,.,.,.,#,.,#
#,.,#,#,#,#,#,.,#,#,#,.,#
#,.,.,.,.,.,.,.,.,.,#,.,#
#,.,#,#,#,.,#,#,#,.,#,.,#
#,.,#,.,#,.,.,.,#,.,.,.,#
#,.,#,.,#,#,#,.,#,.,#,#,#
#,.,.,.,.,.,#,.,.,.,.,G,#
#,#,#,#,#,#,#,#,#,#,#,#,#
