#,#,#,#,#,#,#,#,#,#,#,#,#,#,#,#,#,#,#,#,#,#,#,#,#,#,#,#,#,#,#,#,#,#,#,#,#,#,#,#,#,#,#,#,#
#,S,.,.,#,.,#,.,.,.,.,.,.,.,.,.,#,.,.,.,.,.,.,.,.,.,#,.,.,.,.,.,#,.,.,.,.,.,.,.,.,.,.,.,#
#,#,.,.,#,.,#,.,#,.,#,.,#,#,#,.,#,.,#,#,#,.,#,#,#,.,#,#,#,.,.,#,#,.,#,#,#,.,#,.,#,#,#,.,#
#,.,.,.,#,.,#,.,#,.,.,.,#,.,.,.,#,.,.,.,#,.,.,.,.,.,.,.,#,.,.,.,.,.,.,.,#,.,#,.,.,.,#,.,#
#,.,.,#,#,.,#,.,#,#,#,.,#,.,#,#,#,#,#,.,#,#,#,.,#,#,#,.,#,#,.,#,#,.,#,.,#,.,#,.,#,.,#,.,#
#,.,#,.,.,.,.,.,#,.,.,.,#,.,#,.,.,.,.,.,.,.,#,.,#,.,#,.,#,.,.,.,#,.,#,.,#,.,.,.,.,.,#,.,#
#,.,.,.,#,.,.,.,#,.,#,#,#,.,#,#,#,#,#,#,#,#,#,.,#,.,#,.,#,.,#,.,#,.,#,.,#,#,#,#,.,.,#,.,#
#,.,#,.,#,.,.,.,#,.,.,.,.,.,#,.,.,.,.,.,.,.,#,.,#,.,.,.,.,.,#,.,.,.,.,.,.,.,.,.,.,.,#,.,#
#,.,#,.,.,.,#,.,#,.,#,.,#,#,#,.,#,#,#,#,.,.,#,.,#,.,#,#,#,#,#,.,#,.,#,.,#,.,#,.,#,#,#,.,#
#,.,#,.,.,.,#,.,#,.,#,.,.,.,#,.,#,.,.,.,#,.,#,.,.,.,#,.,.,.,.,.,.,.,#,.,#,.,#,.,#,.,.,.,#
#,.,#,#,#,.,#,.,#,.,#,#,.,.,#,.,#,.,#,.,.,.,#,#,#,.,#,#,#,#,#,.,#,.,#,.,#,.,.,.,#,.,#,#,#
#,.,.,.,#,.,.,.,#,.,#,.,.,.,.,.,#,.,#,.,.,.,.,.,.,.,#,.,.,.,.,.,.,.,.,.,.,.,#,.,#,.,.,.,#
#,#,#,.,#,#,#,#,#,.,.,.,#,#,#,#,#,.,#,#,#,#,#,.,#,#,#,.,#,#,#,.,#,.,#,#,#,#,#,.,#,#,#,.,#
#,.,#,.,.,.,.,.,.,.,#,.,.,.,#,.,.,.,#,.,.,.,.,.,.,.,#,.,.,.,#,.,#,.,#,.,.,.,#,.,#,.,.,.,#
#,.,#,#,#,#,#,#,#,#,#,#,#,.,#,.,#,#,#,.,#,#,#,#,#,.,#,.,#,#,#,.,#,.,#,.,#,.,#,.,#,.,#,#,#
#,.,.,.,.,.,#,.,.,.,.,.,.,.,#,.,#,.,.,.,#,.,.,.,#,.,.,.,#,.,.,.,#,.,#,.,#,.,.,.,#,.,.,.,#
#,.,#,.,#,.,#,.,#,.,#,#,#,.,#,.,#,#,#,#,#,.,.,.,#,#,#,#,#,.,#,#,#,.,#,.,#,.,#,.,#,#,#,.,#
#,.,#,.,#,.,.,.,#,.,.,.,#,.,#,.,.,.,#,.,.,.,#,.,.,.,.,.,.,.,#,.,.,.,#,.,#,.,.,.,#,.,.,.,#
#,.,#,.,#,#,#,.,#,#,.,.,#,.,#,#,#,.,#,.,#,#,#,#,#,#,#,.,#,#,#,.,#,#,#,#,#,#,#,#,#,.,#,.,#
#,.,#,.,.,.,.,.,#,.,.,.,#,.,#,.,.,.,#,.,#,.,.,.,.,.,.,.,.,.,#,.,#,.,.,.,.,.,.,.,.,.,#,.,#
#,#,#,.,#,#,#,#,#,.,.,#,#,.,#,.,#,#,#,.,#,#,.,.,#,.,#,#,#,#,#,.,#,#,#,.,#,.,#,#,#,#,#,#,#
#,.,.,.,.,.,.,.,#,.,#,.,.,.,#,.,#,.,.,.,.,.,#,.,#,.,#,.,.,.,.,.,.,.,.,.,#,.,#,.,.,.,.,.,#
#,.,#,#,#,#,#,.,#,.,#,.,#,#,#,.,#,#,#,.,#,.,#,.,#,.,.,.,#,#,.,.,.,.,#,#,#,#,#,.,.,#,#,.,#
#,.,.,.,#,.,.,.,.,.,#,.,.,.,#,.,.,.,#,.,#,.,#,.,#,.,.,.,#,.,.,.,#,.,#,.,.,.,.,.,.,.,.,.,#
#,.,#,.,#,.,#,.,#,#,#,#,#,#,#,#,#,.,#,#,#,.,#,#,#,.,#,.,#,.,#,.,#,#,#,.,#,#,#,#,#,#,#,.,#
#,.,#,.,.,.,#,.,#,.,.,.,.,.,.,.,.,.,.,.,#,.,.,.,#,.,.,.,#,.,#,.,.,.,.,.,.,.,#,.,.,.,.,.,#
#,.,#,#,.,.,#,#,#,.,#,#,#,.,#,.,#,#,.,.,#,#,#,.,#,.,#,#,#,.,#,.,#,#,#,#,#,#,#,.,#,#,#,#,#
#,.,.,.,#,.,#,.,.,.,#,.,#,.,#,.,#,.,.,.,#,.,.,.,#,.,#,.,.,.,#,.,.,.,.,.,.,.,#,.,.,.,.,.,#
#,#,.,#,#,.,#,.,#,#,#,.,#,.,#,#,#,.,#,#,#,.,#,#,#,.,#,.,#,#,#,.,.,#,#,#,#,.,#,#,.,#,#,.,#
#,.,.,.,.,.,#,.,.,.,.,.,.,.,.,.,#,.,#,.,.,.,#,.,#,.,#,.,#,.,.,.,#,.,.,.,.,.,.,.,.,.,#,.,#
#,.,#,.,#,#,#,#,#,.,#,.,#,#,.,.,#,.,#,.,#,#,#,.,#,.,#,.,#,.,#,.,#,.,#,.,#,#,#,#,#,.,#,.,#
#,.,#,.,#,.,.,.,.,.,#,.,#,.,#,.,.,.,#,.,.,.,#,.,.,.,#,.,#,.,#,.,.,.,#,.,.,.,.,.,#,.,.,.,#
#,.,#,#,#,.,.,.,.,#,#,.,#,.,#,#,#,#,#,#,#,.,#,#,#,#,#,.,#,.,.,.,#,.,#,#,#,#,#,.,#,#,#,#,#
#,.,.,.,#,.,#,.,.,.,.,.,#,.,.,.,.,.,.,.,.,.,#,.,.,.,.,.,#,.,#,.,#,.,.,.,#,.,#,.,.,.,.,.,#
#,.,#,.,#,.,#,#,#,#,#,#,#,.,#,#,#,#,#,.,#,#,#,.,#,#,#,#,#,.,#,#,#,#,#,.,.,.,#,#,#,#,#,.,#
#,.,.,.,#,.,#,.,.,.,.,.,.,.,#,.,.,.,#,.,.,.,.,.,.,.,#,.,#,.,.,.,.,.,.,.,.,.,#,.,.,.,.,.,#
#,.,#,.,#,.,.,.,#,#,#,#,#,.,#,.,#,#,#,#,#,#,#,#,#,.,.,.,#,#,#,#,#,#,#,#,#,#,#,.,#,#,#,#,#
#,.,#,.,.,.,#,.,#,.,.,.,#,.,#,.,#,.,.,.,.,.,#,.,.,.,.,.,.,.,.,.,.,.,#,.,.,.,#,.,.,.,.,.,#
#,.,#,#,#,#,#,#,.,.,#,.,#,.,#,.,#,.,.,.,#,.,#,#,#,#,#,.,#,#,#,#,#,#,#,.,#,.,#,#,#,#,#,.,#
#,.,#,.,.,.,.,.,.,.,#,.,#,.,.,.,#,.,#,.,.,.,.,.,.,.,#,.,#,.,.,.,.,.,#,.,#,.,.,.,.,.,#,.,#
#,.,#,.,#,#,.,#,.,#,#,.,#,#,#,#,#,.,#,#,#,#,#,#,#,.,#,#,#,.,#,#,.,.,#,.,#,#,#,.,.,.,#,.,#
#,.,#,.,#,.,.,.,.,.,#,.,#,.,.,.,#,.,.,.,.,.,.,.,#,.,.,.,.,.,#,.,.,.,#,.,#,.,.,.,#,.,.,.,#
#,.,#,.,#,.,#,#,#,.,#,.,#,.,.,.,#,#,#,#,#,#,#,.,#,#,#,#,#,#,#,.,#,#,#,.,#,.,.,#,#,#,#,.,#
#,.,.,.,#,.,.,.,.,.,.,.,.,.,#,.,.,.,.,.,.,.,.,.,#,.,.,.,.,.,.,.,.,.,.,.,#,.,.,.,.,.,.,G,#
#,#,#,#,#,#,#,#,#,#,#,#,#,#,#,#,#,#,#,#,#,#,#,#,#,#,#,#,#,#,#,#,#,#,#,#,#,#,#,#,#,#,#,#,#
