#,#,#,#,#,#,#,#,#,#,#,#,#,#,#,#,#,#,#,#,#
#,S,#,.,.,.,.,.,.,.,.,.,.,.,.,.,#,.,.,.,#
#,.,#,.,#,#,#,.,#,#,#,.,#,#,#,#,#,.,.,.,#
#,.,#,.,#,.,.,.,#,.,.,.,#,.,.,.,.,.,#,.,#
#,.,#,.,#,.,#,#,#,.,.,.,.,.,#,#,#,#,#,.,#
#,.,#,.,.,.,.,.,.,.,#,.,.,.,.,.,.,.,.,.,#
#,.,#,#,#,#,#,.,#,#,#,#,#,#,#,#,#,.,#,.,#
#,.,.,.,.,.,#,.,.,.,.,.,#,.,#,.,.,.,#,.,#
#,.,#,.,.,.,#,.,#,#,#,.,#,.,#,.,#,#,#,.,#
#,.,.,.,#,.,.,.,#,.,.,.,#,.,.,.,#,.,.,.,#
#,#,#,#,#,.,#,.,#,.,#,.,#,.,#,#,#,.,.,.,#
#,.,#,.,.,.,#,.,#,.,#,.,#,.,.,.,#,.,#,.,#
#,.,#,.,.,#,#,.,#,.,#,.,#,.,#,#,#,.,#,.,#
#,.,.,.,#,.,.,.,#,.,.,.,#,.,#,.,.,.,#,.,#
#,.,#,#,#,.,#,#,#,.,#,#,#,.,#,.,#,#,#,.,#
#,.,.,.,.,.,#,.,.,.,#,.,.,.,#,.,.,.,#,.,#
#,#,#,#,#,#,#,.,#,.,#,.,#,#,#,#,#,.,#,.,#
#,.,.,.,.,.,#,.,#,.,.,.,#,.,.,.,.,.,#,.,#
#,.,#,#,#,.,#,.,#,#,#,#,#,.,#,#,#,#,#,.,#
#,.,.,.,#,.,.,.,.,.,.,.,.,.,#,.,.,.,.,G,#
#,#,#,#,#,#,#,#,#,#,#,#,#,#,#,#,#,#,#,#,#
