#,#,#,#,#,#,#,#,#,#,#,#,#
#,S,.,.,.,.,.,.,.,.,#,.,#
#,#,#,#,#,#,#,#,#,.,#,.,#
#,.,.,.,.,.,.,.,#,.,#,.,#
#,.,#,#,#,#,#,.,#,.,#,.,#
#,.,.,.,#,.,#,.,#,.,#,.,#
#,#,#,.,#,.,#,.,#,.,#,.,#
#,.,#,.,.,.,#,.,.,.,#,.,#
#,.,#,#,#,.,#,#,#,#,#,.,#
#,.,.,.,#,.,.,.,#,.,.,.,#
#,.,#,#,#,#,#,.,#,.,#,.,#
#,.,.,.,.,.,.,.,.,.,#,G,#
#,#,#,#,#,#,#,#,#,#,#,#,#
