#,#,#,#,#,#,#,#,#,#,#,#,#,#,#,#,#,#,#,#,#,#,#,#,#
#,S,#,.,.,.,.,.,.,.,.,.,.,.,.,.,.,.,.,.,.,.,.,.,#
#,.,#,#,#,#,#,.,.,#,#,#,#,#,#,.,#,#,#,#,#,.,#,.,#
#,.,.,.,.,.,#,.,.,.,#,.,.,.,.,.,#,.,.,.,#,.,.,.,#
#,#,#,#,#,.,#,.,#,.,.,.,#,#,#,#,#,.,#,.,#,.,#,#,#
#,.,#,.,.,.,#,.,.,.,#,.,#,.,.,.,#,.,#,.,.,.,#,.,#
#,.,.,.,#,#,#,.,#,#,#,.,#,.,#,#,#,.,#,#,#,#,#,.,#
#,.,.,.,#,.,.,.,.,.,#,.,#,.,.,.,.,.,#,.,.,.,.,.,#
#,.,#,#,#,#,#,.,#,#,#,.,#,.,#,.,#,.,#,.,#,#,#,.,#
#,.,.,.,.,.,#,.,#,.,.,.,#,.,.,.,.,.,#,.,#,.,#,.,#
#,#,#,#,#,.,#,#,#,.,#,#,#,#,#,#,#,.,#,.,#,.,#,.,#
#,.,#,.,.,.,#,.,.,.,#,.,#,.,.,.,#,.,.,.,#,.,#,.,#
#,.,#,.,#,#,#,.,#,#,.,.,.,.,.,.,#,.,.,.,#,.,#,.,#
#,.,#,.,.,.,.,.,#,.,.,.,.,.,#,.,.,.,#,.,.,.,#,.,#
#,.,#,#,#,.,#,#,#,.,#,#,#,.,#,#,#,#,#,#,#,#,#,.,#
#,.,.,.,.,.,.,.,#,.,.,.,#,.,#,.,.,.,.,.,.,.,#,.,#
#,.,#,#,#,.,#,#,#,#,#,.,#,.,#,.,#,#,#,.,#,.,#,.,#
#,.,#,.,#,.,.,.,.,.,.,.,#,.,#,.,#,.,#,.,#,.,.,.,#
#,.,#,.,#,#,#,#,#,#,#,#,#,.,#,.,#,.,#,.,#,.,#,#,#
#,.,.,.,.,.,#,.,.,.,.,.,#,.,.,.,.,.,#,.,.,.,.,.,#
#,#,.,#,#,.,.,.,#,#,#,.,#,#,#,#,#,#,#,#,#,#,#,.,#
#,.,.,.,#,.,#,.,.,.,.,.,#,.,.,.,.,.,.,.,#,.,.,.,#
#,.,#,.,#,.,#,.,#,.,#,#,#,.,#,.,.,#,#,.,#,.,#,.,#
#,.,#,.,.,.,.,.,#,.,.,.,.,.,#,.,.,.,.,.,.,.,#,G,#
#,#,#,#,#,#,#,#,#,#,#,#,#,#,#,#,#,#,#,#,#,#,#,#,#
