#,#,#,#,#,#,#,#,#,#,#,#,#,#,#,#,#,#,#,#,#,#,#,#,#,#,#,#,#,#,#,#,#,#,#,#,#,#,#,#,#,#,#,#,#,#,#,#,#,#,#,#,#,#,#,#,#,#,#,#,#,#,#,#,#,#,#,#,#,#,#,#,#,#,#,#,#,#,#,#,#,#,#
#,S,#,.,.,.,.,.,.,.,.,.,.,.,.,.,#,.,.,.,.,.,.,.,#,.,.,.,.,.,#,.,.,.,.,.,#,.,.,.,.,.,#,.,.,.,#,.,.,.,#,.,.,.,#,.,.,.,.,.,.,.,.,.,#,.,.,.,.,.,.,.,#,.,.,.,.,.,#,.,.,.,#
#,.,#,.,#,#,#,#,#,#,#,.,#,#,#,.,#,#,#,.,#,#,#,.,#,.,.,.,#,.,#,.,#,#,#,.,#,.,#,#,#,.,#,.,#,.,#,.,#,.,.,.,#,.,#,.,#,#,#,#,#,.,#,#,#,.,#,#,#,#,#,.,#,.,#,#,.,.,#,.,#,.,#
#,.,.,.,#,.,.,.,.,.,.,.,#,.,#,.,.,.,.,.,#,.,#,.,#,.,#,.,#,.,.,.,.,.,#,.,.,.,#,.,.,.,#,.,#,.,.,.,#,.,.,.,#,.,#,.,.,.,#,.,#,.,.,.,.,.,.,.,#,.,.,.,#,.,.,.,#,.,.,.,#,.,#
#,.,#,.,#,.,#,.,#,.,#,#,#,.,#,.,#,#,#,#,#,.,#,.,#,#,#,.,#,#,#,#,#,.,#,#,#,#,#,.,#,#,#,.,#,#,#,#,.,.,#,.,#,.,#,#,#,.,#,.,#,#,#,.,#,#,#,.,#,.,#,#,#,.,#,#,#,#,#,#,#,.,#
#,.,#,.,#,.,#,.,#,.,#,.,#,.,.,.,#,.,.,.,.,.,#,.,.,.,#,.,.,.,#,.,.,.,#,.,.,.,#,.,#,.,#,.,.,.,#,.,.,.,#,.,#,.,.,.,#,.,.,.,.,.,#,.,.,.,#,.,#,.,#,.,.,.,.,.,.,.,#,.,.,.,#
#,.,#,.,#,.,#,#,#,.,#,.,#,.,#,.,#,.,#,.,#,#,#,#,#,.,#,#,#,.,#,#,.,.,#,.,#,.,#,.,#,.,#,.,#,.,#,.,#,#,#,.,#,#,#,.,#,#,#,.,.,#,#,.,#,.,#,.,#,.,#,.,#,#,#,.,#,.,#,.,#,.,#
#,.,#,.,#,.,#,.,.,.,#,.,.,.,#,.,.,.,#,.,.,.,.,.,#,.,.,.,#,.,#,.,.,.,#,.,#,.,.,.,.,.,.,.,#,.,#,.,.,.,.,.,.,.,#,.,.,.,.,.,#,.,.,.,#,.,.,.,.,.,#,.,.,.,#,.,#,.,.,.,#,.,#
#,.,#,.,#,.,#,.,#,#,#,.,#,#,#,#,#,#,#,.,#,.,#,.,#,#,.,.,#,.,#,.,#,.,#,.,#,#,#,#,#,#,#,#,#,.,#,#,#,.,#,#,#,.,.,.,#,#,#,.,#,.,#,#,#,#,#,#,.,#,#,#,#,.,#,.,#,#,#,#,#,.,#
#,.,#,.,.,.,#,.,#,.,.,.,#,.,.,.,.,.,#,.,#,.,#,.,.,.,#,.,#,.,#,.,#,.,#,.,#,.,.,.,#,.,.,.,.,.,#,.,.,.,#,.,.,.,#,.,.,.,.,.,#,.,.,.,.,.,#,.,.,.,.,.,.,.,#,.,.,.,#,.,#,.,#
#,.,#,#,#,#,#,.,#,#,#,#,#,.,#,#,#,.,#,#,#,.,#,#,#,.,#,.,#,.,#,.,#,.,#,.,#,.,#,.,#,.,#,#,#,#,#,.,#,#,#,#,#,#,#,.,#,#,#,#,#,#,#,#,#,.,#,.,#,#,#,#,#,#,#,#,#,.,#,.,#,.,#
#,.,.,.,.,.,#,.,#,.,.,.,.,.,#,.,#,.,#,.,.,.,#,.,#,.,#,.,.,.,#,.,#,.,#,.,.,.,#,.,.,.,.,.,.,.,#,.,.,.,.,.,.,.,#,.,#,.,.,.,.,.,.,.,#,.,.,.,.,.,#,.,#,.,.,.,#,.,#,.,.,.,#
#,#,.,#,#,.,#,.,#,.,#,#,#,.,#,.,#,.,#,.,#,#,#,.,#,.,#,#,#,#,#,.,#,#,#,#,#,#,#,.,#,#,#,#,#,.,#,#,#,.,#,#,#,.,#,.,#,.,#,#,.,#,#,#,#,#,#,#,#,.,#,.,#,.,#,.,#,.,#,.,#,#,#
#,.,.,.,#,.,.,.,#,.,#,.,.,.,.,.,.,.,.,.,#,.,.,.,.,.,#,.,.,.,#,.,.,.,.,.,.,.,.,.,.,.,.,.,.,.,.,.,.,.,.,.,#,.,#,.,#,.,#,.,.,.,#,.,.,.,.,.,#,.,#,.,.,.,.,.,.,.,#,.,#,.,#
#,.,#,.,#,#,#,.,#,.,#,.,#,#,#,#,#,#,#,#,#,#,#,.,#,#,#,#,#,.,#,.,#,#,#,#,#,#,#,#,#,.,#,.,#,.,#,#,#,#,.,.,#,.,#,.,#,.,#,.,#,.,#,.,#,#,#,.,#,.,#,.,#,.,#,#,#,#,#,.,#,.,#
#,.,#,.,.,.,.,.,#,.,#,.,.,.,#,.,.,.,.,.,.,.,#,.,.,.,.,.,#,.,#,.,#,.,.,.,.,.,.,.,#,.,#,.,#,.,.,.,.,.,#,.,#,.,#,.,.,.,#,.,#,.,.,.,#,.,.,.,#,.,.,.,#,.,#,.,.,.,.,.,#,.,#
#,.,#,.,#,#,#,.,#,.,#,#,#,.,#,.,#,#,#,#,#,.,#,#,#,#,#,.,#,.,#,.,.,.,#,.,.,.,#,.,.,.,.,.,#,#,#,#,#,#,#,.,#,.,#,#,#,.,#,.,#,#,#,#,#,.,#,#,#,#,#,.,#,.,#,#,.,#,#,.,#,.,#
#,.,#,.,.,.,#,.,#,.,#,.,.,.,.,.,.,.,#,.,.,.,.,.,.,.,#,.,#,.,#,.,#,.,#,.,#,.,#,.,.,.,#,.,.,.,.,.,.,.,.,.,#,.,.,.,#,.,#,.,#,.,.,.,#,.,#,.,.,.,#,.,#,.,.,.,.,.,#,.,#,.,#
#,#,#,#,#,.,#,.,#,.,#,.,#,#,#,#,#,#,#,.,#,#,#,.,#,.,#,.,#,.,#,.,.,.,#,.,#,.,#,.,#,#,#,.,#,#,#,#,#,#,#,.,#,#,#,.,#,.,.,.,#,.,#,.,#,.,#,.,#,.,#,#,#,.,#,#,#,.,#,.,#,.,#
#,.,.,.,#,.,#,.,.,.,#,.,.,.,#,.,.,.,#,.,#,.,.,.,#,.,#,.,#,.,#,.,.,.,#,.,#,.,.,.,.,.,.,.,#,.,.,.,.,.,#,.,.,.,#,.,#,.,#,.,#,.,#,.,#,.,.,.,#,.,.,.,.,.,.,.,#,.,#,.,.,.,#
#,.,#,.,#,.,#,#,#,#,#,.,#,.,.,.,.,.,.,.,#,.,#,#,#,.,#,.,#,.,#,.,#,.,#,#,#,#,#,#,#,#,#,.,#,.,#,.,.,#,#,#,#,.,#,.,#,.,#,.,#,.,#,.,#,#,#,#,#,#,#,#,#,#,#,.,#,.,#,#,#,#,#
#,.,#,.,.,.,#,.,.,.,.,.,#,.,#,.,#,.,.,.,#,.,#,.,.,.,#,.,#,.,#,.,#,.,.,.,.,.,#,.,.,.,#,.,#,.,#,.,#,.,.,.,.,.,#,.,#,.,#,.,#,.,#,.,.,.,#,.,.,.,.,.,.,.,#,.,#,.,.,.,.,.,#
#,.,#,#,#,#,#,.,.,#,#,.,#,.,#,.,#,#,#,#,#,.,#,.,#,.,#,.,#,.,#,.,#,#,#,.,.,.,#,.,#,.,.,.,#,.,#,#,#,.,.,#,#,#,.,.,#,.,#,.,#,#,#,.,#,.,#,.,#,#,#,#,#,.,#,.,#,.,.,#,#,.,#
#,.,#,.,.,.,.,.,#,.,#,.,.,.,#,.,#,.,.,.,.,.,#,.,#,.,#,.,#,.,.,.,#,.,.,.,.,.,#,.,#,.,.,.,#,.,#,.,.,.,.,.,#,.,.,.,#,.,.,.,.,.,.,.,#,.,#,.,.,.,.,.,#,.,#,.,#,.,.,.,#,.,#
#,.,#,.,#,#,#,#,#,.,#,#,#,#,#,.,#,#,#,#,#,#,#,.,#,.,#,.,#,#,#,.,.,.,#,#,#,.,#,.,#,#,#,#,#,.,#,.,#,#,#,.,#,.,#,#,.,.,#,#,#,.,#,.,#,#,#,#,#,#,#,.,#,.,#,.,#,#,#,#,#,.,#
#,.,.,.,.,.,.,.,.,.,.,.,.,.,#,.,#,.,.,.,.,.,.,.,.,.,#,.,.,.,#,.,.,.,#,.,#,.,#,.,#,.,.,.,.,.,#,.,.,.,.,.,#,.,#,.,.,.,#,.,.,.,#,.,#,.,.,.,.,.,.,.,#,.,#,.,.,.,.,.,.,.,#
#,.,#,#,#,.,#,#,#,.,#,#,#,#,#,.,#,.,#,.,.,.,#,#,#,.,#,#,.,.,#,#,.,#,#,.,.,.,#,.,#,.,#,.,#,#,#,#,#,.,#,#,#,.,#,.,#,.,#,#,#,.,#,#,#,.,#,#,#,#,#,#,#,.,#,#,#,#,#,#,#,.,#
#,.,.,.,.,.,#,.,.,.,#,.,.,.,#,.,#,.,.,.,#,.,#,.,.,.,.,.,#,.,.,.,.,.,.,.,.,.,.,.,.,.,#,.,.,.,.,.,.,.,#,.,.,.,#,.,#,.,.,.,#,.,.,.,#,.,#,.,.,.,.,.,.,.,.,.,.,.,#,.,.,.,#
#,.,#,#,#,.,#,.,#,.,#,.,.,.,.,.,#,#,#,.,#,.,#,.,#,#,#,#,#,.,#,.,#,#,#,.,#,.,#,.,#,#,#,.,#,.,#,#,#,#,#,.,.,#,#,.,#,#,#,.,#,#,#,.,#,.,#,.,#,#,#,#,#,#,#,#,#,.,#,.,#,#,#
#,.,#,.,.,.,#,.,.,.,#,.,#,.,.,.,.,.,#,.,#,.,#,.,.,.,#,.,.,.,#,.,.,.,#,.,.,.,#,.,.,.,#,.,.,.,#,.,.,.,#,.,#,.,.,.,#,.,.,.,#,.,.,.,.,.,#,.,#,.,.,.,.,.,.,.,.,.,#,.,#,.,#
#,#,#,.,#,.,#,#,#,#,#,.,#,#,#,.,#,#,#,.,#,.,#,#,#,.,#,.,#,#,#,#,#,#,#,#,.,#,#,.,#,.,.,#,#,.,#,#,#,.,#,.,#,.,#,#,#,.,#,#,#,.,#,#,#,.,#,.,#,.,#,#,#,#,#,.,#,.,#,.,#,.,#
#,.,.,.,#,.,.,.,.,.,.,.,#,.,.,.,.,.,.,.,.,.,.,.,.,.,#,.,#,.,.,.,.,.,.,.,.,.,#,.,#,.,.,.,#,.,.,.,#,.,.,.,#,.,#,.,.,.,#,.,.,.,.,.,.,.,#,.,#,.,.,.,.,.,.,.,#,.,#,.,.,.,#
#,.,#,#,#,#,#,#,#,#,#,.,#,.,#,#,.,#,#,#,#,.,#,.,#,.,#,.,#,.,#,#,#,#,#,.,#,.,#,#,#,.,#,.,#,.,#,.,#,.,#,.,#,.,#,.,#,#,#,.,#,#,#,.,#,#,#,.,#,#,#,.,#,#,#,.,.,#,#,.,#,.,#
#,.,#,.,#,.,.,.,.,.,.,.,#,.,#,.,.,.,.,.,.,.,#,.,.,.,#,.,.,.,#,.,#,.,.,.,#,.,.,.,#,.,#,.,.,.,#,.,.,.,#,.,#,.,#,.,#,.,.,.,.,.,#,.,.,.,#,.,.,.,.,.,#,.,#,.,.,.,.,.,#,.,#
#,.,#,.,#,.,#,#,#,#,#,.,.,.,#,#,#,.,#,.,.,#,#,.,#,.,#,.,#,.,#,.,#,.,#,.,#,#,#,.,#,.,#,#,#,.,.,#,#,.,#,.,#,#,#,.,#,.,#,.,#,.,#,#,#,.,.,#,#,#,#,#,#,.,#,.,#,#,#,.,#,.,#
#,.,#,.,.,.,#,.,.,.,#,.,.,.,.,.,.,.,#,.,.,.,.,.,#,.,.,.,.,.,#,.,.,.,#,.,#,.,.,.,#,.,.,.,#,.,.,.,#,.,#,.,.,.,.,.,#,.,.,.,#,.,.,.,#,.,.,.,#,.,#,.,.,.,.,.,.,.,#,.,.,.,#
#,.,.,.,#,#,#,.,#,.,#,#,#,#,#,#,#,.,#,.,#,#,.,#,#,#,#,#,#,#,#,#,#,.,#,.,#,.,#,#,#,#,#,#,#,#,.,.,.,.,#,#,#,.,#,#,#,#,.,.,#,.,#,#,#,#,#,.,#,.,.,.,#,#,#,#,#,.,#,#,#,#,#
#,.,.,.,.,.,.,.,#,.,.,.,.,.,.,.,#,.,#,.,#,.,.,.,.,.,.,.,#,.,.,.,#,.,#,.,.,.,.,.,.,.,.,.,.,.,.,.,#,.,#,.,.,.,.,.,#,.,.,.,#,.,#,.,.,.,.,.,#,.,.,.,#,.,.,.,#,.,.,.,.,.,#
#,.,#,#,#,.,#,#,#,#,#,.,#,#,#,.,#,.,#,.,#,.,#,#,#,#,#,.,#,.,#,.,#,#,#,#,#,#,#,#,#,#,.,#,.,.,#,#,#,#,#,.,#,.,#,#,#,.,#,#,#,.,.,.,#,#,#,#,#,.,#,.,#,.,#,.,#,#,#,.,#,.,#
#,.,.,.,.,.,.,.,.,.,#,.,.,.,.,.,.,.,#,.,.,.,#,.,.,.,#,.,#,.,#,.,.,.,.,.,.,.,.,.,.,.,.,.,#,.,#,.,.,.,.,.,.,.,.,.,#,.,.,.,#,.,#,.,#,.,.,.,.,.,#,.,.,.,.,.,.,.,#,.,#,.,#
#,.,#,.,#,.,#,.,#,.,#,#,#,#,#,#,#,#,#,#,#,#,#,.,#,.,#,.,#,.,#,#,#,#,#,.,#,#,#,#,#,#,#,.,#,#,.,.,#,#,#,.,#,#,.,.,#,#,#,.,#,.,#,.,#,.,#,#,#,#,#,.,#,#,#,#,#,.,.,#,#,.,#
#,.,#,.,#,.,#,.,#,.,.,.,#,.,.,.,.,.,.,.,#,.,.,.,#,.,#,.,.,.,#,.,.,.,.,.,.,.,.,.,.,.,.,.,#,.,.,.,#,.,.,.,.,.,#,.,#,.,.,.,#,.,#,.,#,.,.,.,.,.,#,.,.,.,.,.,#,.,.,.,.,.,#
#,.,#,.,#,.,#,.,#,#,#,.,#,.,#,#,#,.,#,#,#,.,#,.,#,.,#,#,#,#,#,.,#,#,#,#,#,.,#,#,#,#,.,.,#,.,#,#,#,.,#,.,#,#,#,.,#,.,#,#,#,.,#,.,#,#,#,#,#,.,#,#,#,#,#,.,#,#,#,#,#,.,#
#,.,#,.,#,.,#,.,.,.,.,.,#,.,#,.,.,.,.,.,.,.,#,.,.,.,.,.,.,.,.,.,.,.,#,.,#,.,#,.,.,.,.,.,#,.,.,.,.,.,#,.,.,.,.,.,#,.,.,.,#,.,.,.,#,.,.,.,#,.,.,.,#,.,.,.,.,.,.,.,.,.,#
#,.,#,.,#,.,#,.,#,#,#,#,#,.,#,.,#,#,#,#,.,#,#,.,#,#,#,#,#,.,#,#,#,.,#,.,.,.,#,.,#,.,#,#,#,#,#,#,#,.,#,#,#,.,#,#,#,#,#,.,#,#,#,#,#,.,#,.,#,#,#,.,#,.,#,#,#,.,#,.,#,#,#
#,.,#,.,#,.,#,.,.,.,.,.,.,.,#,.,.,.,#,.,.,.,#,.,.,.,.,.,.,.,.,.,.,.,.,.,#,.,#,.,#,.,#,.,.,.,.,.,.,.,#,.,.,.,#,.,.,.,.,.,.,.,.,.,.,.,#,.,.,.,#,.,.,.,#,.,.,.,#,.,.,.,#
#,.,#,.,#,.,#,#,#,#,#,#,#,.,.,.,#,.,#,.,#,#,#,.,#,.,#,.,#,.,#,.,#,#,#,#,#,.,#,.,#,#,#,.,#,#,#,#,#,.,#,.,#,.,#,.,#,#,#,.,#,#,.,.,#,.,#,#,#,.,#,#,.,.,#,.,.,.,#,#,#,.,#
#,.,.,.,.,.,.,.,.,.,.,.,.,.,.,.,#,.,.,.,#,.,.,.,#,.,.,.,#,.,.,.,.,.,.,.,.,.,#,.,.,.,.,.,#,.,.,.,.,.,.,.,#,.,.,.,#,.,.,.,.,.,.,.,.,.,#,.,.,.,#,.,#,.,#,.,.,.,#,.,.,.,#
#,#,.,#,#,#,#,#,#,#,#,.,#,#,#,#,#,#,.,#,#,.,#,#,#,.,#,#,#,#,#,.,#,#,#,#,#,.,#,#,#,#,#,.,#,.,#,#,#,#,#,#,#,.,#,.,#,#,#,#,#,.,#,#,#,.,#,.,#,#,#,.,#,.,#,#,.,.,#,.,#,#,#
#,.,.,.,.,.,.,.,.,.,#,.,.,.,.,.,#,.,.,.,.,.,.,.,.,.,.,.,.,.,.,.,.,.,.,.,.,.,#,.,.,.,#,.,#,.,#,.,.,.,#,.,.,.,#,.,.,.,.,.,.,.,#,.,.,.,.,.,#,.,.,.,.,.,#,.,.,.,#,.,.,.,#
#,.,#,#,#,#,#,.,#,#,#,#,#,#,#,.,#,.,#,.,#,#,#,#,#,#,.,#,#,.,#,.,#,.,#,#,#,#,#,.,#,.,#,#,#,.,#,.,#,#,.,.,#,#,#,#,#,#,#,.,.,.,#,#,#,#,#,.,#,#,#,#,#,#,#,.,#,#,#,#,#,.,#
#,.,#,.,.,.,.,.,.,.,.,.,.,.,.,.,.,.,#,.,#,.,.,.,.,.,.,.,.,.,.,.,.,.,.,.,.,.,#,.,#,.,.,.,.,.,#,.,.,.,.,.,#,.,.,.,.,.,.,.,#,.,.,.,.,.,#,.,.,.,.,.,.,.,.,.,#,.,#,.,.,.,#
#,.,#,.,#,#,#,#,#,#,#,#,#,#,#,#,#,#,#,#,#,.,#,#,#,#,#,.,#,#,.,.,#,#,#,.,#,.,#,.,#,#,#,#,#,#,#,.,#,#,#,#,#,.,#,#,#,.,#,#,#,.,#,#,#,.,#,#,#,#,#,#,#,#,#,#,#,.,#,.,#,#,#
#,.,.,.,#,.,.,.,.,.,.,.,#,.,.,.,#,.,.,.,#,.,.,.,#,.,.,.,#,.,.,.,.,.,#,.,#,.,#,.,.,.,.,.,#,.,.,.,#,.,.,.,#,.,.,.,#,.,.,.,.,.,#,.,.,.,.,.,.,.,#,.,.,.,.,.,.,.,#,.,#,.,#
#,.,#,#,#,.,#,#,.,#,#,#,#,.,.,.,#,.,#,.,#,#,#,.,#,.,#,#,#,.,.,#,#,.,.,.,#,.,#,#,#,#,#,.,#,.,#,.,.,.,#,#,#,#,.,.,#,.,#,#,#,#,#,.,#,.,#,#,#,.,#,#,#,#,#,.,#,#,#,.,.,.,#
#,.,#,.,.,.,.,.,.,.,.,.,#,.,#,.,#,.,#,.,.,.,.,.,.,.,.,.,.,.,#,.,.,.,.,.,#,.,.,.,.,.,.,.,#,.,#,.,.,.,#,.,.,.,#,.,#,.,#,.,.,.,.,.,.,.,.,.,#,.,.,.,.,.,#,.,.,.,#,.,.,.,#
#,.,#,#,#,.,#,.,#,#,#,.,#,.,#,.,#,.,#,#,#,#,#,#,#,#,#,.,#,#,#,#,#,#,#,.,#,.,#,#,#,.,#,#,#,.,#,.,#,#,#,.,#,.,#,.,#,.,.,#,#,.,#,.,.,#,#,#,#,.,#,#,#,.,.,.,.,.,#,#,#,.,#
#,.,.,.,.,.,#,.,.,.,#,.,#,.,#,.,.,.,#,.,.,.,.,.,.,.,.,.,#,.,.,.,.,.,#,.,.,.,.,.,.,.,#,.,.,.,#,.,#,.,.,.,#,.,.,.,#,.,.,.,.,.,#,.,#,.,.,.,#,.,.,.,.,.,#,.,#,.,.,.,.,.,#
#,#,#,#,#,.,.,.,#,#,.,.,#,.,#,#,#,#,.,.,#,.,#,#,#,#,#,#,#,.,#,#,.,.,#,#,#,.,#,.,#,.,.,.,#,#,#,.,.,.,#,#,#,#,#,#,#,.,#,#,#,#,#,.,#,.,#,.,#,.,#,.,#,#,#,.,#,#,#,.,#,.,#
#,.,#,.,.,.,#,.,.,.,.,.,#,.,.,.,.,.,.,.,.,.,.,.,#,.,.,.,#,.,#,.,.,.,.,.,#,.,#,.,#,.,#,.,.,.,.,.,#,.,.,.,#,.,.,.,.,.,#,.,.,.,.,.,.,.,#,.,.,.,#,.,.,.,#,.,#,.,.,.,#,.,#
#,.,#,.,#,#,#,#,#,.,#,#,#,#,#,.,#,#,#,.,#,.,#,.,#,.,.,.,#,.,#,.,#,#,#,.,#,.,#,.,#,#,.,.,#,#,#,#,#,#,#,.,.,.,#,#,#,#,#,.,#,#,#,#,#,#,#,#,#,#,#,.,#,#,#,.,#,.,.,#,#,.,#
#,.,#,.,#,.,.,.,#,.,.,.,.,.,.,.,.,.,.,.,.,.,#,.,#,.,.,.,#,.,#,.,.,.,#,.,#,.,#,.,.,.,.,.,.,.,.,.,.,.,#,.,#,.,.,.,.,.,#,.,.,.,.,.,#,.,#,.,.,.,.,.,#,.,.,.,.,.,.,.,.,.,#
#,.,#,.,#,.,#,.,.,#,.,#,#,#,#,#,#,#,#,.,#,#,#,.,#,.,#,.,#,.,#,.,#,.,#,.,.,#,#,.,#,#,#,.,#,.,#,#,#,.,#,.,#,.,#,#,#,.,#,#,#,#,#,.,#,.,#,.,#,#,#,.,#,.,#,#,#,#,#,#,#,.,#
#,.,#,.,#,.,#,.,.,.,.,.,.,.,.,.,.,.,.,.,#,.,.,.,#,.,#,.,.,.,#,.,#,.,.,.,.,.,#,.,.,.,.,.,#,.,#,.,.,.,#,.,#,.,.,.,#,.,.,.,.,.,#,.,.,.,.,.,.,.,#,.,.,.,#,.,.,.,.,.,#,.,#
#,.,#,.,#,.,#,#,#,#,#,#,#,#,#,#,#,#,#,.,#,.,#,#,#,.,#,#,#,#,#,#,#,.,#,#,.,.,#,#,#,#,#,#,#,.,#,.,#,.,#,.,#,#,#,.,#,.,#,#,#,.,#,.,#,#,#,#,#,#,#,.,#,#,#,.,#,#,#,.,#,#,#
#,.,.,.,#,.,.,.,#,.,.,.,#,.,.,.,.,.,#,.,#,.,.,.,.,.,#,.,.,.,.,.,#,.,#,.,.,.,#,.,.,.,.,.,#,.,#,.,.,.,#,.,#,.,#,.,.,.,.,.,#,.,#,.,.,.,.,.,.,.,.,.,#,.,.,.,.,.,#,.,.,.,#
#,.,#,#,#,#,#,.,.,.,.,.,#,#,#,#,#,.,.,.,#,#,#,#,#,#,#,.,#,.,#,.,#,.,#,.,#,#,#,.,#,#,#,.,#,.,#,#,.,.,#,.,#,.,.,.,#,#,#,.,#,.,#,#,#,#,#,#,#,.,#,.,#,.,#,#,#,#,#,#,#,.,#
#,.,#,.,.,.,.,.,#,.,#,.,#,.,.,.,.,.,#,.,#,.,.,.,.,.,#,.,#,.,#,.,.,.,#,.,#,.,.,.,#,.,#,.,.,.,#,.,#,.,.,.,#,.,.,.,#,.,.,.,#,.,.,.,#,.,.,.,.,.,#,.,#,.,.,.,#,.,.,.,.,.,#
#,.,#,.,#,.,#,#,#,.,.,.,.,.,#,#,#,.,#,.,#,#,#,.,#,.,#,.,#,.,#,#,#,.,#,.,#,.,#,#,#,.,.,#,#,#,#,.,#,#,#,#,.,.,#,#,#,.,.,.,#,.,#,#,#,.,#,#,#,#,#,#,#,.,#,#,#,.,#,#,#,.,#
#,.,.,.,#,.,#,.,.,.,.,.,.,.,#,.,.,.,#,.,.,.,#,.,.,.,.,.,#,.,#,.,.,.,#,.,.,.,#,.,.,.,.,.,.,.,#,.,.,.,.,.,.,.,.,.,.,.,#,.,#,.,.,.,#,.,#,.,.,.,.,.,.,.,#,.,.,.,#,.,#,.,#
#,.,#,.,#,.,#,.,#,.,#,#,#,#,#,.,#,.,#,#,#,.,#,.,#,#,#,#,#,.,#,#,#,#,#,.,#,#,#,.,#,#,#,#,#,.,#,.,#,#,#,#,#,#,.,#,#,.,#,#,#,.,#,.,#,.,#,.,#,#,#,#,.,#,#,.,#,#,#,.,#,.,#
#,.,.,.,.,.,#,.,.,.,.,.,.,.,.,.,#,.,#,.,#,.,#,.,.,.,.,.,#,.,.,.,.,.,.,.,.,.,.,.,#,.,.,.,.,.,#,.,.,.,.,.,#,.,.,.,.,.,.,.,.,.,#,.,#,.,.,.,#,.,.,.,.,.,.,.,#,.,#,.,.,.,#
#,#,#,#,#,#,#,#,#,#,#,.,#,#,#,.,.,.,.,.,#,.,#,.,#,#,#,#,#,.,#,#,.,.,#,#,#,#,#,.,#,#,#,#,#,#,#,#,#,.,#,.,#,.,.,.,#,#,#,#,#,#,#,.,#,#,#,#,#,.,#,#,#,#,.,#,#,.,#,.,#,#,#
#,.,.,.,#,.,.,.,.,.,#,.,.,.,#,.,.,.,#,.,#,.,#,.,#,.,.,.,.,.,.,.,.,.,#,.,.,.,.,.,#,.,.,.,.,.,#,.,.,.,.,.,#,.,.,.,#,.,.,.,.,.,#,.,#,.,.,.,.,.,#,.,.,.,.,.,#,.,#,.,.,.,#
#,.,#,.,#,.,#,.,.,.,#,#,#,.,#,.,.,#,#,.,#,.,#,.,#,.,#,#,#,.,#,#,.,#,#,#,#,#,#,#,#,.,#,#,#,.,#,.,#,#,#,#,#,#,#,.,#,.,#,.,.,.,#,.,.,.,.,#,#,#,#,.,#,#,#,.,#,.,#,.,#,.,#
#,.,.,.,.,.,#,.,.,.,.,.,.,.,.,.,#,.,.,.,#,.,#,.,#,.,.,.,.,.,.,.,.,.,.,.,.,.,#,.,.,.,#,.,#,.,.,.,#,.,.,.,.,.,.,.,#,.,.,.,#,.,#,.,#,.,#,.,.,.,.,.,#,.,.,.,#,.,#,.,.,.,#
#,.,#,#,#,.,#,.,#,#,#,#,#,#,#,.,#,.,.,.,.,.,#,#,#,#,.,#,#,#,#,#,#,.,#,#,#,.,#,.,#,#,#,.,#,#,#,#,#,.,#,.,#,#,#,#,#,#,#,.,#,#,#,.,#,.,#,#,#,#,#,.,#,.,#,#,#,.,.,.,#,#,#
#,.,.,.,.,.,#,.,.,.,#,.,.,.,.,.,.,.,#,.,#,.,.,.,#,.,.,.,#,.,.,.,#,.,.,.,.,.,.,.,.,.,.,.,#,.,.,.,.,.,#,.,.,.,#,.,.,.,.,.,#,.,.,.,#,.,.,.,.,.,#,.,#,.,.,.,#,.,#,.,#,.,#
#,.,#,#,#,#,#,.,.,.,#,#,#,#,#,#,#,#,#,#,#,#,#,.,#,.,.,.,#,.,#,.,#,#,#,.,#,#,#,#,#,#,#,.,#,.,.,#,#,#,#,.,#,#,#,.,#,.,#,.,#,.,.,#,#,#,#,#,#,.,#,.,#,#,#,.,#,.,#,.,#,.,#
#,.,.,.,.,.,#,.,#,.,.,.,.,.,#,.,.,.,.,.,.,.,.,.,#,.,#,.,.,.,.,.,#,.,.,.,.,.,#,.,.,.,#,.,#,.,.,.,#,.,.,.,#,.,.,.,#,.,#,.,#,.,.,.,.,.,#,.,.,.,#,.,.,.,#,.,.,.,#,.,#,.,#
#,#,#,#,#,.,#,.,#,#,#,#,#,.,#,.,#,#,#,#,#,#,#,#,#,.,#,#,#,#,.,.,#,.,.,#,#,.,#,.,#,.,#,#,#,#,#,.,#,.,#,#,#,.,.,#,#,.,#,#,#,#,#,#,#,.,#,.,#,#,#,.,#,.,#,#,#,#,#,.,#,.,#
#,.,.,.,.,.,.,.,.,.,.,.,#,.,.,.,.,.,.,.,.,.,.,.,.,.,#,.,.,.,.,.,.,.,#,.,.,.,.,.,#,.,.,.,.,.,.,.,#,.,.,.,.,.,.,.,#,.,.,.,.,.,.,.,.,.,.,.,#,.,.,.,#,.,.,.,.,.,.,.,.,G,#
#,#,#,#,#,#,#,#,#,#,#,#,#,#,#,#,#,#,#,#,#,#,#,#,#,#,#,#,#,#,#,#,#,#,#,#,#,#,#,#,#,#,#,#,#,#,#,#,#,#,#,#,#,#,#,#,#,#,#,#,#,#,#,#,#,#,#,#,#,#,#,#,#,#,#,#,#,#,#,#,#,#,#
