#,#,#,#,#,#,#,#,#,#,#
#,S,.,.,.,.,#,.,.,.,#
#,#,.,#,#,.,#,#,#,.,#
#,.,.,.,#,.,.,.,#,.,#
#,#,#,.,#,#,#,.,#,.,#
#,.,.,.,#,.,.,.,#,.,#
#,.,#,#,#,.,#,#,#,.,#
#,.,.,.,.,.,#,.,.,.,#
#,.,#,.,#,#,#,.,#,.,#
#,.,.,.,.,.,.,.,#,G,#
#,#,#,#,#,#,#,#,#,#,#
