#,#,#,#,#,#,#,#,#,#,#,#,#,#,#,#,#,#,#
#,S,#,.,.,.,.,.,.,.,.,.,.,.,.,.,.,.,#
#,.,#,.,#,#,#,#,#,#,#,#,#,.,#,#,#,#,#
#,.,#,.,.,.,.,.,.,.,.,.,#,.,.,.,.,.,#
#,.,#,#,#,#,#,#,#,#,#,.,#,#,#,#,#,.,#
#,.,.,.,#,.,.,.,.,.,#,.,.,.,.,.,.,.,#
#,#,#,.,#,#,#,#,#,.,#,.,#,.,#,#,#,.,#
#,.,#,.,.,.,.,.,#,.,#,.,#,.,.,.,#,.,#
#,.,#,.,#,#,#,.,#,.,.,.,.,#,#,.,#,#,#
#,.,.,.,#,.,.,.,.,.,.,.,.,.,#,.,.,.,#
#,#,#,.,#,.,#,#,#,#,#,#,#,.,#,#,#,.,#
#,.,.,.,#,.,.,.,.,.,.,.,#,.,.,.,#,.,#
#,.,#,#,#,#,#,.,#,#,#,.,#,.,#,#,.,.,#
#,.,.,.,.,.,.,.,#,.,.,.,#,.,#,.,.,.,#
#,.,.,.,#,#,#,.,#,.,#,#,#,.,#,.,#,.,#
#,.,#,.,.,.,#,.,#,.,.,.,#,.,#,.,#,.,#
#,.,#,#,#,.,#,#,#,.,.,.,#,#,#,.,.,.,#
#,.,.,.,#,.,.,.,.,.,.,.,.,.,.,.,#,G,#
#,#,#,#,#,#,#,#,#,#,#,#,#,#,#,#,#,#,#
