#,#,#,#,#,#,#,#,#,#,#,#,#,#,#,#,#,#,#,#,#,#,#
#,S,.,.,.,.,.,.,#,.,.,.,#,.,.,.,.,.,.,.,#,.,#
#,#,#,#,#,#,#,.,#,.,#,.,#,.,#,#,#,#,#,.,#,.,#
#,.,.,.,.,.,#,.,.,.,#,.,.,.,#,.,.,.,#,.,#,.,#
#,.,#,#,#,.,#,.,#,.,#,#,#,#,#,.,#,.,#,.,#,.,#
#,.,#,.,.,.,.,.,#,.,.,.,#,.,.,.,#,.,.,.,#,.,#
#,.,#,#,#,#,#,.,#,.,#,.,#,.,#,#,#,.,#,#,#,.,#
#,.,#,.,.,.,.,.,.,.,.,.,#,.,.,.,#,.,.,.,.,.,#
#,.,#,.,#,#,#,#,#,.,#,#,#,#,#,.,#,#,#,#,#,.,#
#,.,.,.,.,.,.,.,.,.,#,.,.,.,#,.,.,.,.,.,#,.,#
#,.,#,#,#,.,#,#,#,#,#,.,#,#,#,#,#,#,#,.,#,.,#
#,.,.,.,.,.,.,.,.,.,#,.,.,.,.,.,.,.,#,.,.,.,#
#,.,#,#,#,#,#,.,#,.,#,.,#,#,#,.,#,.,#,#,#,.,#
#,.,.,.,.,.,.,.,#,.,#,.,.,.,.,.,.,.,.,.,#,.,#
#,.,#,#,#,.,#,#,#,#,#,.,#,.,#,.,#,#,#,.,#,.,#
#,.,#,.,.,.,#,.,.,.,#,.,.,.,.,.,#,.,.,.,#,.,#
#,#,#,.,#,.,#,.,#,.,#,.,#,#,#,.,#,#,#,.,#,.,#
#,.,.,.,.,.,#,.,#,.,.,.,.,.,#,.,.,.,#,.,#,.,#
#,.,#,#,#,#,#,.,#,.,#,#,#,.,#,#,#,.,#,#,#,.,#
#,.,#,.,.,.,#,.,#,.,.,.,#,.,.,.,.,.,#,.,.,.,#
#,.,#,.,#,.,#,.,.,.,#,#,#,#,#,.,#,.,#,.,.,#,#
#,.,.,.,#,.,.,.,#,.,.,.,.,.,.,.,#,.,.,.,.,G,#
#,#,#,#,#,#,#,#,#,#,#,#,#,#,#,#,#,#,#,#,#,#,#
