#,#,#,#,#,#,#,#,#,#,#,#,#,#,#,#,#,#,#
#,S,#,.,.,.,#,.,.,.,.,.,.,.,.,.,.,.,#
#,.,#,.,#,.,#,.,#,#,#,.,#,#,#,#,#,#,#
#,.,.,.,#,.,#,.,.,.,#,.,.,.,.,.,.,.,#
#,#,#,#,#,.,#,#,#,.,#,#,#,#,#,#,#,.,#
#,.,.,.,.,.,#,.,.,.,.,.,#,.,#,.,.,.,#
#,.,#,#,#,#,#,#,#,#,#,.,#,.,#,.,#,.,#
#,.,.,.,#,.,.,.,#,.,.,.,.,.,#,.,#,.,#
#,#,#,.,#,.,#,.,#,.,#,#,#,#,#,.,#,.,#
#,.,.,.,#,.,#,.,#,.,.,.,#,.,.,.,#,.,#
#,.,#,#,#,.,#,.,#,#,#,#,#,.,#,#,#,.,#
#,.,.,.,.,.,#,.,.,.,.,.,.,.,#,.,.,.,#
#,#,#,#,#,#,#,#,#,#,#,#,#,#,#,.,#,#,#
#,.,.,.,.,.,#,.,.,.,.,.,.,.,#,.,#,.,#
#,.,#,#,#,#,#,.,#,.,#,#,#,#,#,.,#,.,#
#,.,.,.,.,.,.,.,#,.,#,.,.,.,.,.,#,.,#
#,.,#,#,#,#,#,#,#,.,#,.,#,#,#,#,#,.,#
#,.,.,.,.,.,.,.,#,.,.,.,.,.,.,.,.,G,#
#,#,#,#,#,#,#,#,#,#,#,#,#,#,#,#,#,#,#
