#,#,#,#,#,#,#,#,#,#,#
#,S,.,.,.,.,#,.,.,.,#
#,#,#,#,#,.,#,.,#,.,#
#,.,.,.,.,.,#,.,.,.,#
#,.,#,#,#,#,#,.,#,.,#
#,.,.,.,.,.,#,.,#,.,#
#,#,#,#,#,.,.,.,#,.,#
#,.,.,.,#,.,#,.,#,.,#
#,.,#,#,#,.,#,.,#,.,#
#,.,.,.,.,.,.,.,#,G,#
#,#,#,#,#,#,#,#,#,#,#
