#,#,#,#,#,#,#,#,#,#,#,#,#,#,#,#,#,#,#,#,#
#,S,#,.,.,.,#,.,.,.,.,.,.,.,.,.,#,.,.,.,#
#,.,#,.,.,#,#,.,#,.,#,#,#,#,#,.,#,#,#,.,#
#,.,#,.,.,.,.,.,#,.,.,.,#,.,.,.,.,.,#,.,#
#,.,#,.,#,#,#,.,#,.,#,.,#,.,#,#,#,.,#,.,#
#,.,.,.,.,.,#,.,.,.,.,.,#,.,.,.,.,.,#,.,#
#,.,#,#,#,.,#,.,#,#,#,#,#,.,#,#,#,#,#,.,#
#,.,#,.,.,.,#,.,.,.,#,.,.,.,.,.,.,.,.,.,#
#,.,#,#,#,#,#,#,#,.,.,#,#,.,#,#,#,.,#,.,#
#,.,.,.,.,.,.,.,#,.,.,.,.,.,.,.,#,.,.,.,#
#,#,#,#,#,#,#,.,#,#,#,.,#,.,.,.,#,#,#,.,#
#,.,.,.,.,.,#,.,.,.,#,.,#,.,.,.,.,.,#,.,#
#,.,#,#,#,.,#,#,#,.,#,.,#,.,#,#,#,.,#,.,#
#,.,#,.,.,.,.,.,#,.,#,.,#,.,.,.,#,.,.,.,#
#,.,#,#,#,#,#,#,#,.,#,.,#,#,#,#,#,#,#,#,#
#,.,.,.,.,.,.,.,#,.,.,.,.,.,.,.,.,.,.,.,#
#,.,#,#,#,#,#,.,#,.,#,#,#,#,#,.,.,#,#,.,#
#,.,.,.,.,.,#,.,.,.,#,.,.,.,#,.,#,.,.,.,#
#,#,#,#,#,.,#,#,#,#,#,.,#,.,#,#,.,.,#,.,#
#,.,.,.,.,.,.,.,.,.,.,.,#,.,.,.,.,.,#,G,#
#,#,#,#,#,#,#,#,#,#,#,#,#,#,#,#,#,#,#,#,#
