#,#,#,#,#,#,#,#,#,#,#,#,#,#,#
#,S,#,.,.,.,#,.,.,.,.,.,.,.,#
#,.,#,.,#,.,#,.,#,.,#,.,#,.,#
#,.,#,.,#,.,.,.,#,.,#,.,.,.,#
#,.,#,.,#,#,#,.,#,.,.,.,#,#,#
#,.,#,.,.,.,#,.,.,.,#,.,.,.,#
#,.,#,#,#,.,#,#,.,#,#,.,#,.,#
#,.,.,.,.,.,#,.,.,.,#,.,.,.,#
#,#,#,#,#,#,#,.,#,.,#,#,#,.,#
#,.,.,.,#,.,.,.,#,.,#,.,.,.,#
#,#,#,.,#,.,#,.,#,#,#,.,#,#,#
#,.,.,.,#,.,#,.,#,.,.,.,#,.,#
#,.,#,#,#,.,.,.,#,.,#,#,#,.,#
#,.,.,.,.,.,#,.,.,.,.,.,.,G,#
#,#,#,#,#,#,#,#,#,#,#,#,#,#,#
