#,#,#,#,#,#,#,#,#,#,#,#,#,#,#,#,#,#,#,#,#,#,#,#,#,#,#,#,#,#,#,#,#,#,#,#,#,#,#,#,#,#,#,#,#,#,#,#,#,#,#,#,#,#,#,#,#,#,#,#,#,#,#,#,#,#,#,#,#,#,#,#,#,#,#,#,#,#,#,#,#,#,#,#,#,#,#,#,#,#,#,#,#,#,#,#,#,#,#,#,#
#,S,.,.,.,.,#,.,.,.,.,.,.,.,#,.,.,.,.,.,#,.,.,.,.,.,.,.,.,.,.,.,.,.,.,.,.,.,.,.,#,.,.,.,.,.,.,.,.,.,#,.,.,.,.,.,.,.,.,.,.,.,.,.,#,.,.,.,.,.,#,.,#,.,.,.,.,.,.,.,.,.,.,.,.,.,#,.,.,.,.,.,.,.,.,.,.,.,.,.,#
#,#,#,#,#,.,#,.,#,#,#,.,#,.,#,.,#,#,.,.,.,.,#,.,#,#,#,#,#,.,#,.,#,#,#,#,#,#,#,.,.,#,.,.,#,#,#,.,.,.,#,.,#,.,#,#,#,#,#,.,#,#,#,.,#,.,#,.,#,.,#,.,#,.,#,#,#,#,#,#,#,#,#,#,#,.,#,.,#,#,#,.,#,#,#,.,#,#,#,.,#
#,.,.,.,#,.,.,.,#,.,.,.,.,.,#,.,#,.,.,.,#,.,#,.,.,.,.,.,.,.,#,.,#,.,.,.,.,.,#,.,.,.,#,.,#,.,.,.,#,.,#,.,#,.,#,.,.,.,#,.,.,.,.,.,#,.,#,.,#,.,.,.,#,.,.,.,#,.,.,.,.,.,.,.,#,.,#,.,#,.,.,.,.,.,#,.,#,.,#,.,#
#,.,#,#,#,#,#,#,#,.,#,#,#,#,#,.,#,#,#,#,#,.,#,.,#,.,#,#,#,.,#,.,#,.,#,.,#,#,#,.,#,.,#,.,#,.,#,#,#,.,#,.,.,.,#,.,#,.,#,.,.,#,#,#,#,#,#,.,#,#,#,.,.,#,#,.,#,#,#,#,#,.,#,.,#,.,#,.,#,.,#,.,#,#,#,.,#,.,#,.,#
#,.,.,.,#,.,.,.,#,.,#,.,.,.,.,.,.,.,.,.,#,.,#,.,#,.,.,.,.,.,.,.,#,.,#,.,.,.,.,.,#,.,.,.,#,.,.,.,#,.,#,.,#,.,#,.,#,.,#,.,.,.,#,.,.,.,#,.,.,.,#,.,.,.,#,.,.,.,#,.,.,.,#,.,#,.,#,.,.,.,#,.,#,.,.,.,#,.,.,.,#
#,.,.,.,#,.,#,.,#,.,#,.,#,#,#,#,.,#,#,.,#,.,#,.,#,#,#,#,#,.,#,.,#,.,#,#,#,.,#,#,#,#,#,#,#,#,#,.,#,.,.,.,#,.,#,#,#,.,#,#,#,.,#,.,#,.,#,#,#,.,#,.,#,.,#,#,#,.,#,.,#,#,#,.,.,.,#,.,#,#,#,.,#,.,#,#,#,.,#,#,#
#,.,#,.,.,.,.,.,.,.,#,.,.,.,.,.,.,.,#,.,#,.,#,.,#,.,.,.,.,.,#,.,.,.,.,.,#,.,#,.,.,.,.,.,.,.,.,.,#,.,#,.,#,.,.,.,#,.,.,.,#,.,#,.,#,.,.,.,.,.,#,.,#,.,.,.,#,.,#,.,#,.,.,.,#,.,.,.,#,.,.,.,.,.,#,.,#,.,#,.,#
#,.,#,#,#,#,#,#,#,#,#,.,#,#,#,#,#,#,#,.,#,.,#,#,#,.,.,#,#,#,#,#,#,#,.,.,#,.,#,.,.,.,#,#,#,#,#,#,#,.,#,#,#,#,.,.,#,.,#,#,#,.,#,.,#,#,#,.,#,#,#,#,#,.,.,.,#,.,#,.,#,#,#,#,#,#,#,#,#,.,.,.,#,.,#,.,#,.,.,.,#
#,.,#,.,#,.,.,.,#,.,.,.,.,.,.,.,.,.,#,.,#,.,.,.,.,.,.,.,.,.,#,.,.,.,.,.,#,.,.,.,#,.,.,.,.,.,.,.,#,.,.,.,#,.,.,.,#,.,#,.,.,.,#,.,.,.,#,.,#,.,.,.,.,.,#,.,.,.,#,.,#,.,.,.,.,.,.,.,.,.,#,.,#,.,#,.,.,.,.,.,#
#,.,#,.,#,.,#,.,#,.,#,.,#,#,#,#,#,.,#,.,#,#,#,#,#,.,#,.,.,.,#,.,#,#,.,#,#,#,#,.,#,#,#,#,#,#,#,.,#,#,#,.,.,.,#,#,#,.,#,.,#,#,#,.,#,.,#,.,#,.,#,#,#,#,#,#,#,#,#,.,.,.,#,#,#,.,#,.,#,#,#,#,.,.,#,#,#,.,#,#,#
#,.,#,.,#,.,#,.,#,.,#,.,#,.,.,.,.,.,#,.,.,.,.,.,#,.,#,.,#,.,.,.,#,.,.,.,.,.,#,.,.,.,.,.,#,.,.,.,.,.,#,.,.,.,#,.,.,.,#,.,#,.,.,.,#,.,#,.,#,.,.,.,.,.,#,.,#,.,.,.,#,.,.,.,.,.,.,.,#,.,.,.,.,.,#,.,.,.,.,.,#
#,.,.,.,#,.,#,.,#,.,#,.,#,.,#,#,#,#,#,#,.,.,#,.,#,.,.,.,#,.,#,#,#,.,.,#,#,.,#,#,#,#,#,#,#,.,#,#,.,#,#,#,#,#,#,#,#,.,.,.,#,#,#,#,#,.,#,#,#,#,#,.,#,.,#,.,#,.,.,.,#,#,#,.,#,.,#,#,#,.,#,#,#,#,#,.,#,#,#,.,#
#,.,.,.,.,.,#,.,.,.,#,.,.,.,#,.,.,.,.,.,#,.,#,.,.,.,.,.,#,.,.,.,#,.,.,.,#,.,#,.,.,.,.,.,#,.,.,.,.,.,#,.,.,.,.,.,#,.,#,.,#,.,.,.,#,.,#,.,.,.,.,.,.,.,#,.,.,.,#,.,.,.,.,.,#,.,.,.,#,.,#,.,.,.,.,.,.,.,#,.,#
#,.,#,#,#,.,#,#,#,#,#,.,#,.,#,.,#,#,.,.,#,#,#,#,.,#,#,.,#,.,#,.,#,#,#,.,#,.,#,.,#,#,#,.,#,.,#,#,#,.,#,.,#,.,#,.,#,.,#,.,#,.,#,.,#,.,#,.,#,.,#,.,#,#,#,#,#,#,#,.,.,.,#,#,#,#,#,.,.,.,#,.,.,#,.,#,#,.,#,.,#
#,.,.,.,#,.,.,.,.,.,.,.,#,.,#,.,#,.,.,.,.,.,.,.,.,.,.,.,#,.,#,.,.,.,.,.,.,.,#,.,.,.,#,.,#,.,.,.,.,.,.,.,#,.,#,.,.,.,#,.,.,.,#,.,#,.,#,.,#,.,.,.,#,.,.,.,.,.,.,.,#,.,.,.,#,.,.,.,#,.,#,.,#,.,.,.,#,.,.,.,#
#,#,.,.,#,.,#,.,#,#,#,#,#,.,#,.,#,.,#,#,#,.,#,.,#,#,#,#,#,.,#,.,#,#,#,#,#,.,#,#,#,.,#,.,#,#,#,#,#,.,#,.,#,.,#,#,#,.,#,#,#,#,#,.,#,.,#,.,#,#,#,#,#,.,#,#,#,#,#,.,#,#,#,.,#,.,#,.,#,.,.,.,#,#,#,.,.,.,#,#,#
#,.,#,.,#,.,#,.,.,.,.,.,#,.,.,.,#,.,#,.,.,.,#,.,#,.,.,.,.,.,.,.,#,.,.,.,#,.,.,.,#,.,#,.,.,.,.,.,#,.,.,.,#,.,#,.,.,.,.,.,.,.,#,.,#,.,#,.,#,.,#,.,.,.,.,.,#,.,.,.,#,.,.,.,.,.,#,.,.,.,.,.,#,.,.,.,#,.,.,.,#
#,.,#,.,.,.,#,.,#,.,#,.,#,.,#,#,#,#,#,.,#,.,#,.,#,.,#,#,#,#,#,#,#,.,#,.,#,.,.,#,#,.,#,#,#,#,#,.,#,#,#,.,#,.,#,.,#,#,#,#,.,#,#,.,#,.,#,.,#,.,#,.,#,#,#,.,#,#,#,.,#,.,#,#,.,#,#,.,#,#,#,.,#,.,#,#,#,#,#,.,#
#,.,.,.,#,.,#,.,#,.,#,.,.,.,#,.,.,.,.,.,#,.,.,.,#,.,.,.,#,.,.,.,#,.,#,.,#,.,.,.,#,.,.,.,#,.,#,.,.,.,#,.,#,.,#,.,#,.,.,.,.,.,.,.,.,.,.,.,#,.,.,.,#,.,.,.,.,.,#,.,.,.,#,.,.,.,#,.,#,.,#,.,.,.,#,.,.,.,.,.,#
#,.,#,#,#,.,#,.,#,.,#,#,#,#,#,.,#,#,.,#,#,#,#,.,.,#,#,.,#,.,#,.,#,.,#,.,#,#,#,.,#,#,#,.,.,.,#,#,#,.,#,.,#,.,#,#,#,.,#,#,#,#,#,#,#,#,#,.,#,.,#,.,#,.,#,#,#,.,#,#,#,#,#,.,#,.,#,.,#,.,#,.,#,.,.,.,#,#,#,.,#
#,.,.,.,#,.,#,.,#,.,#,.,#,.,.,.,#,.,.,.,.,.,.,.,.,.,#,.,#,.,#,.,.,.,#,.,.,.,.,.,.,.,#,.,#,.,.,.,#,.,#,.,#,.,.,.,.,.,#,.,.,.,#,.,#,.,.,.,#,.,.,.,#,.,.,.,#,.,.,.,.,.,#,.,#,.,#,.,#,.,.,.,#,.,.,.,.,.,#,.,#
#,#,#,.,#,.,#,.,#,.,#,.,#,.,#,#,#,#,#,.,#,.,#,#,#,.,#,.,#,.,#,#,#,#,#,#,#,#,#,#,#,.,#,.,#,.,#,.,#,.,#,#,#,#,#,#,#,.,#,.,#,.,#,.,#,.,#,.,#,#,#,.,#,.,#,.,#,#,#,#,#,.,#,.,#,#,#,.,#,.,#,#,#,.,#,#,#,.,#,.,#
#,.,#,.,#,.,#,.,#,.,.,.,#,.,.,.,#,.,.,.,#,.,#,.,.,.,#,.,.,.,.,.,.,.,.,.,.,.,#,.,.,.,#,.,.,.,#,.,#,.,.,.,.,.,.,.,#,.,.,.,#,.,.,.,#,.,#,.,.,.,.,.,#,.,.,.,.,.,.,.,#,.,#,.,.,.,.,.,#,.,.,.,#,.,.,.,#,.,#,.,#
#,.,#,.,#,.,#,.,#,#,#,#,#,#,#,.,#,.,#,#,#,#,#,.,#,.,#,.,#,#,#,#,#,#,#,#,#,.,#,#,#,#,#,#,#,.,#,#,#,#,#,#,#,#,#,.,#,#,.,#,#,#,.,.,#,.,#,.,#,#,#,#,#,#,#,.,#,.,#,.,.,.,.,.,#,#,#,#,#,.,#,#,#,#,#,.,#,.,#,.,#
#,.,.,.,#,.,.,.,#,.,.,.,.,.,#,.,.,.,#,.,.,.,.,.,#,.,#,.,.,.,#,.,#,.,.,.,.,.,.,.,.,.,.,.,.,.,.,.,.,.,.,.,.,.,#,.,#,.,.,.,.,.,.,.,.,.,#,.,#,.,.,.,.,.,#,.,.,.,#,.,#,.,#,.,#,.,.,.,.,.,.,.,.,.,.,.,#,.,.,.,#
#,.,#,#,#,.,#,.,#,.,#,#,#,.,.,.,#,#,#,.,.,.,.,#,#,#,#,#,#,.,#,.,#,.,#,.,#,#,#,#,#,#,#,#,#,.,#,.,#,#,#,#,#,.,#,.,.,.,.,.,#,#,.,#,#,.,#,.,#,.,#,#,#,.,.,.,#,.,#,#,#,.,#,.,#,.,#,#,#,.,#,#,#,#,#,#,.,.,#,.,#
#,.,#,.,.,.,#,.,.,.,#,.,.,.,#,.,#,.,.,.,#,.,#,.,.,.,.,.,#,.,.,.,.,.,#,.,.,.,#,.,.,.,.,.,#,.,#,.,#,.,.,.,#,.,.,.,#,.,.,.,#,.,.,.,#,.,#,.,.,.,#,.,.,.,#,.,#,.,#,.,.,.,#,.,.,.,#,.,.,.,#,.,.,.,#,.,.,.,#,.,#
#,.,#,#,#,#,#,#,#,#,#,.,.,#,.,.,#,.,#,#,#,.,#,.,#,.,#,#,#,.,#,#,.,.,#,#,#,.,.,.,#,#,#,.,#,#,.,.,#,.,#,#,#,.,#,#,#,#,.,.,#,.,.,.,#,.,#,.,#,.,#,.,#,#,#,.,#,.,.,.,#,#,#,.,#,#,#,#,#,.,#,.,#,.,#,.,.,#,#,.,#
#,.,#,.,.,.,.,.,#,.,.,.,#,.,.,.,#,.,.,.,#,.,#,.,#,.,.,.,#,.,#,.,.,.,#,.,.,.,.,.,.,.,.,.,.,.,.,.,#,.,.,.,.,.,.,.,.,.,.,.,#,.,#,.,#,.,.,.,.,.,#,.,.,.,.,.,#,.,.,.,.,.,.,.,.,.,.,.,#,.,.,.,#,.,.,.,#,.,#,.,#
#,.,#,.,#,#,#,.,#,.,#,.,#,.,#,#,#,#,#,.,#,#,#,.,#,.,#,.,#,.,#,.,#,#,#,.,#,.,#,#,#,#,#,.,#,.,#,#,#,.,#,#,#,.,#,#,#,#,#,.,#,.,#,.,#,.,#,#,#,.,#,#,#,.,#,#,#,#,#,.,#,#,#,#,.,#,#,.,#,.,#,#,#,#,#,.,#,.,#,.,#
#,.,.,.,.,.,#,.,.,.,#,.,.,.,#,.,.,.,#,.,.,.,.,.,#,.,#,.,.,.,#,.,#,.,.,.,#,.,.,.,.,.,#,.,.,.,#,.,.,.,.,.,#,.,#,.,.,.,.,.,#,.,.,.,#,.,.,.,.,.,.,.,.,.,.,.,.,.,#,.,.,.,.,.,.,.,#,.,#,.,#,.,#,.,.,.,.,.,.,.,#
#,.,#,#,#,.,#,#,#,#,#,#,#,.,#,.,#,.,#,#,#,#,#,.,#,.,#,#,#,#,#,.,.,#,#,#,#,.,#,#,#,.,#,#,#,.,#,#,#,#,#,#,#,.,#,.,#,#,#,#,#,.,#,#,#,#,#,.,#,#,#,.,#,.,#,.,.,.,#,.,#,#,#,#,#,.,.,.,#,.,#,.,#,.,#,#,#,#,#,#,#
#,.,.,.,#,.,.,.,#,.,.,.,#,.,.,.,#,.,.,.,#,.,.,.,.,.,.,.,#,.,#,.,.,.,.,.,.,.,#,.,#,.,#,.,.,.,#,.,.,.,.,.,#,.,.,.,.,.,.,.,.,.,#,.,.,.,#,.,.,.,#,.,#,.,#,.,#,.,.,.,.,.,.,.,.,.,.,.,#,.,#,.,.,.,.,.,.,.,#,.,#
#,#,#,.,#,.,#,.,#,.,.,.,#,.,#,#,#,#,#,.,#,.,#,#,#,.,#,.,#,.,#,#,#,#,#,#,#,.,#,.,#,.,#,#,#,#,#,.,#,#,.,.,.,#,#,#,#,#,#,#,.,#,#,.,#,.,#,#,#,.,#,.,.,.,#,.,#,.,#,.,#,#,#,.,#,#,#,#,#,.,#,#,#,#,#,.,#,.,#,.,#
#,.,.,.,#,.,#,.,.,.,#,.,.,.,.,.,.,.,.,.,#,.,.,.,#,.,#,.,#,.,.,.,.,.,.,.,.,.,.,.,#,.,.,.,.,.,.,.,.,.,#,.,.,.,#,.,.,.,.,.,.,.,.,.,#,.,.,.,.,.,#,.,.,.,#,.,#,.,.,.,#,.,.,.,#,.,.,.,#,.,#,.,.,.,#,.,.,.,.,.,#
#,.,#,#,#,.,#,.,#,.,#,#,#,.,.,#,#,.,#,.,#,#,#,.,#,.,#,.,#,#,#,.,#,#,#,#,#,#,.,.,#,#,#,#,#,#,#,#,#,.,#,#,#,.,#,.,#,#,#,#,#,#,#,#,#,#,#,#,#,#,#,#,#,.,#,.,#,#,#,#,#,#,#,#,#,.,#,.,#,.,#,.,#,.,#,#,#,#,#,#,#
#,.,#,.,.,.,.,.,#,.,.,.,#,.,.,.,#,.,#,.,.,.,.,.,#,.,#,.,.,.,.,.,#,.,.,.,.,.,#,.,#,.,.,.,.,.,.,.,#,.,.,.,.,.,#,.,#,.,.,.,#,.,.,.,.,.,.,.,.,.,.,.,#,.,#,.,.,.,.,.,#,.,.,.,#,.,#,.,#,.,#,.,#,.,.,.,.,.,.,.,#
#,.,#,#,#,.,#,.,#,#,#,.,#,.,#,.,#,.,#,#,#,#,.,#,#,.,#,#,#,#,#,#,#,.,#,.,#,.,#,.,#,.,#,#,#,#,#,.,#,.,#,#,#,#,#,.,#,.,#,.,#,#,#,.,#,.,#,.,#,.,#,.,#,.,#,.,#,#,#,.,#,.,#,.,#,.,#,.,#,.,#,.,.,#,#,#,#,#,#,.,#
#,.,.,.,#,.,#,.,.,.,#,.,#,.,.,.,.,.,.,.,.,.,.,.,.,.,#,.,.,.,#,.,.,.,#,.,#,.,#,.,#,.,.,.,.,.,.,.,#,.,.,.,.,.,#,.,.,.,#,.,.,.,.,.,#,.,#,.,#,.,#,.,.,.,#,.,.,.,#,.,.,.,#,.,#,.,#,.,#,.,#,.,.,.,.,.,#,.,.,.,#
#,#,#,.,#,.,#,#,#,#,#,.,#,.,#,.,#,#,#,#,#,.,#,#,#,.,#,.,#,.,#,.,#,#,#,.,#,.,#,.,#,#,#,.,#,.,#,.,#,#,#,#,#,.,#,#,#,#,#,#,#,#,#,#,#,.,#,#,#,.,#,#,#,.,#,#,#,#,#,#,#,#,#,.,#,.,#,.,#,.,#,#,#,#,#,.,#,.,#,#,#
#,.,.,.,.,.,.,.,#,.,.,.,#,.,#,.,#,.,.,.,.,.,#,.,#,.,#,.,#,.,#,.,.,.,#,.,#,.,#,.,.,.,.,.,#,.,.,.,.,.,#,.,#,.,.,.,.,.,.,.,#,.,.,.,#,.,#,.,.,.,#,.,.,.,.,.,.,.,.,.,.,.,#,.,#,.,.,.,.,.,#,.,.,.,#,.,#,.,.,.,#
#,.,.,#,#,.,#,.,#,.,#,#,#,.,#,#,#,.,#,.,#,.,#,.,#,.,#,.,#,.,#,#,#,.,#,.,#,.,#,#,#,#,#,#,#,#,#,#,#,.,#,.,#,.,#,.,#,#,.,.,#,.,.,.,#,.,#,.,#,#,#,#,#,#,#,#,#,#,#,.,#,.,#,.,#,.,#,#,#,.,#,#,#,.,#,.,#,#,#,.,#
#,.,#,.,#,.,#,.,#,.,.,.,#,.,.,.,#,.,#,.,.,.,#,.,.,.,.,.,#,.,#,.,.,.,.,.,#,.,.,.,#,.,.,.,.,.,.,.,#,.,#,.,#,.,.,.,#,.,.,.,.,.,#,.,#,.,#,.,.,.,.,.,#,.,.,.,.,.,#,.,.,.,#,.,#,.,#,.,.,.,.,.,#,.,#,.,#,.,#,.,#
#,.,#,.,#,.,#,.,#,#,#,.,#,#,#,.,#,.,#,.,.,.,#,#,#,#,#,#,#,#,#,.,#,#,#,#,#,#,#,.,#,.,#,#,#,#,.,.,#,.,#,.,#,.,#,#,#,#,#,#,#,.,#,.,#,.,#,.,.,.,#,.,#,.,#,#,#,.,#,.,#,#,#,.,#,.,#,#,#,#,#,.,#,.,#,.,#,.,#,.,#
#,.,#,.,.,.,#,.,.,.,#,.,#,.,.,.,#,.,#,.,#,.,#,.,.,.,.,.,.,.,#,.,.,.,#,.,.,.,.,.,.,.,#,.,.,.,#,.,.,.,.,.,#,.,.,.,.,.,.,.,#,.,.,.,#,.,#,.,.,.,#,.,#,.,#,.,.,.,#,.,.,.,.,.,#,.,.,.,.,.,#,.,.,.,#,.,.,.,#,.,#
#,.,#,#,#,.,#,#,#,.,#,.,#,.,.,.,#,.,#,.,.,.,#,.,#,.,#,#,#,.,#,#,#,.,#,.,#,.,#,.,#,#,#,.,#,.,#,#,#,#,#,.,#,#,#,#,#,#,.,.,#,#,.,.,#,.,#,#,#,#,#,.,#,.,#,#,#,#,#,#,#,#,#,.,#,#,.,#,#,.,#,#,#,#,#,.,.,.,#,.,#
#,.,.,.,#,.,.,.,.,.,.,.,#,.,#,.,#,.,#,.,.,.,#,.,.,.,#,.,#,.,.,.,.,.,#,.,#,.,#,.,#,.,.,.,#,.,.,.,.,.,#,.,.,.,.,.,.,.,.,.,.,.,#,.,#,.,.,.,#,.,.,.,#,.,#,.,.,.,.,.,.,.,.,.,#,.,.,.,#,.,.,.,.,.,#,.,#,.,.,.,#
#,#,#,.,#,#,#,.,#,#,#,#,#,.,#,#,#,.,#,.,#,#,#,#,#,.,#,.,#,#,#,#,#,#,#,.,#,.,#,#,#,.,#,#,#,#,#,#,#,.,#,.,#,#,#,#,#,#,#,#,#,.,#,.,#,.,#,.,#,.,#,#,#,.,#,.,#,.,#,#,#,.,.,#,.,.,#,.,#,#,#,#,#,.,#,.,#,.,#,#,#
#,.,.,.,#,.,.,.,.,.,.,.,.,.,#,.,.,.,#,.,.,.,.,.,.,.,#,.,#,.,.,.,.,.,#,.,.,.,.,.,.,.,.,.,.,.,.,.,#,.,#,.,#,.,.,.,.,.,#,.,.,.,#,.,.,.,#,.,.,.,.,.,.,.,.,.,#,.,.,.,.,.,.,.,.,.,.,.,#,.,.,.,#,.,.,.,#,.,.,.,#
#,.,#,#,#,.,#,#,#,.,#,#,#,.,#,.,#,#,#,#,#,#,#,#,#,#,#,.,#,.,#,#,#,.,#,.,#,#,#,#,#,#,#,.,#,#,#,#,#,.,#,#,#,.,#,#,#,.,#,.,#,#,#,#,#,.,#,#,.,#,#,.,#,#,#,#,#,#,#,#,.,#,#,#,#,.,#,.,#,.,#,.,#,.,#,#,#,#,#,.,#
#,.,.,.,#,.,.,.,#,.,#,.,.,.,.,.,.,.,#,.,.,.,.,.,.,.,.,.,#,.,#,.,.,.,#,.,#,.,#,.,.,.,.,.,.,.,.,.,#,.,.,.,.,.,#,.,#,.,#,.,#,.,.,.,#,.,#,.,.,.,#,.,.,.,.,.,#,.,.,.,.,.,.,.,#,.,#,.,.,.,#,.,.,.,.,.,.,.,#,.,#
#,#,#,.,#,.,#,#,.,.,#,#,#,#,#,#,.,.,#,#,#,#,#,.,#,.,#,.,#,.,#,.,#,#,#,.,.,.,#,.,.,#,#,#,#,#,#,.,#,#,#,#,#,#,#,.,#,.,#,.,#,.,#,#,#,.,#,.,#,#,#,#,#,#,#,.,#,.,#,.,#,#,#,.,.,.,#,#,#,#,.,.,#,#,#,.,#,#,#,.,#
#,.,#,.,#,.,#,.,.,.,#,.,.,.,.,.,#,.,.,.,#,.,.,.,#,.,#,.,.,.,#,.,.,.,#,.,.,.,#,.,.,.,.,.,.,.,#,.,.,.,#,.,.,.,.,.,.,.,#,.,#,.,.,.,.,.,#,.,.,.,.,.,.,.,#,.,.,.,#,.,.,.,#,.,.,.,.,.,.,.,.,.,#,.,.,.,.,.,#,.,#
#,.,#,.,#,.,#,.,#,#,#,.,#,.,#,.,#,#,.,.,#,.,#,#,#,.,#,#,#,#,#,.,#,.,#,.,#,.,#,#,#,.,#,.,#,#,#,#,#,.,#,.,#,#,#,.,#,#,#,.,#,.,#,#,#,#,#,#,#,.,#,#,#,#,#,#,#,.,#,.,#,.,#,#,#,#,#,#,#,.,#,#,#,.,#,#,#,.,#,.,#
#,.,#,.,#,.,#,.,.,.,.,.,.,.,.,.,.,.,#,.,.,.,#,.,.,.,.,.,.,.,.,.,.,.,#,.,#,.,.,.,#,.,#,.,.,.,.,.,.,.,#,.,#,.,.,.,.,.,.,.,#,.,.,.,.,.,.,.,#,.,#,.,.,.,.,.,#,.,.,.,#,.,#,.,.,.,#,.,.,.,#,.,.,.,.,.,.,.,.,.,#
#,.,#,.,#,.,#,#,.,#,#,.,#,#,#,#,#,.,#,#,.,.,#,#,#,#,#,#,#,.,#,#,#,#,#,.,#,.,#,#,#,.,#,.,.,.,#,#,#,.,#,.,#,#,#,#,#,.,#,.,#,.,#,#,#,#,#,.,#,.,#,.,#,.,#,.,#,.,#,#,#,.,#,.,.,.,#,.,#,#,#,.,#,#,#,.,#,#,#,#,#
#,.,#,.,.,.,.,.,.,.,#,.,#,.,.,.,#,.,.,.,.,.,#,.,.,.,.,.,.,.,#,.,.,.,#,.,#,.,.,.,.,.,.,.,.,.,.,.,.,.,#,.,#,.,.,.,.,.,#,.,.,.,.,.,.,.,#,.,.,.,.,.,#,.,#,.,.,.,#,.,#,.,#,.,#,.,#,.,#,.,#,.,.,.,#,.,#,.,.,.,#
#,.,#,.,#,.,#,#,#,.,#,#,#,.,#,.,#,#,#,.,#,#,#,.,#,.,#,#,#,#,#,.,.,.,.,.,#,.,#,#,#,#,#,.,#,#,#,.,#,#,#,.,#,.,#,#,#,#,#,#,#,#,#,#,#,.,#,.,#,#,#,#,#,.,#,.,#,#,#,.,#,.,#,.,#,.,#,.,#,.,#,#,#,.,#,#,#,.,#,.,#
#,.,#,.,#,.,.,.,.,.,.,.,#,.,#,.,.,.,#,.,#,.,.,.,#,.,.,.,#,.,.,.,#,.,.,.,.,.,.,.,.,.,#,.,.,.,#,.,#,.,.,.,#,.,.,.,.,.,.,.,.,.,.,.,#,.,.,.,.,.,.,.,.,.,#,.,.,.,#,.,.,.,#,.,#,.,#,.,.,.,#,.,#,.,.,.,.,.,#,.,#
#,.,#,.,#,.,#,#,#,#,#,.,#,.,#,#,#,.,#,#,#,.,#,.,#,#,#,.,.,.,#,.,#,.,#,#,#,#,#,#,#,.,#,#,#,.,#,.,#,.,#,#,#,#,#,#,#,.,#,.,#,#,#,.,#,#,#,#,#,.,#,#,#,#,#,.,#,.,#,.,#,.,#,.,#,.,#,#,#,.,#,.,#,#,#,#,#,.,#,.,#
#,.,#,.,.,.,.,.,#,.,.,.,.,.,#,.,#,.,.,.,.,.,#,.,#,.,.,.,#,.,.,.,#,.,#,.,.,.,.,.,.,.,#,.,#,.,.,.,#,.,#,.,.,.,.,.,#,.,.,.,.,.,#,.,.,.,.,.,#,.,#,.,.,.,#,.,#,.,#,.,.,.,.,.,.,.,.,.,.,.,.,.,.,.,.,.,.,.,#,.,#
#,.,#,.,.,#,#,.,#,.,#,#,#,#,#,.,#,#,#,#,.,#,#,.,#,.,#,.,#,#,#,.,#,.,#,.,#,#,#,#,#,.,#,.,#,.,#,.,#,.,#,.,.,#,#,.,#,#,#,#,.,.,#,#,#,#,#,.,#,#,#,.,#,.,.,.,#,.,#,#,#,#,#,#,#,#,#,#,#,.,.,#,#,#,#,#,#,#,#,.,#
#,.,#,.,.,.,.,.,#,.,.,.,.,.,.,.,.,.,.,.,.,.,#,.,.,.,#,.,.,.,.,.,.,.,.,.,#,.,.,.,#,.,.,.,#,.,#,.,#,.,.,.,#,.,#,.,.,.,.,.,#,.,.,.,.,.,#,.,.,.,.,.,#,.,#,.,#,.,.,.,.,.,.,.,.,.,.,.,.,.,#,.,.,.,.,.,.,.,.,.,#
#,.,.,#,#,#,#,#,#,.,#,#,#,.,#,#,#,#,#,#,#,#,#,.,#,.,#,#,#,.,#,#,#,.,#,#,#,.,#,.,#,#,#,.,#,.,#,.,#,#,#,#,#,.,#,#,#,#,#,.,#,.,#,#,#,#,#,#,#,.,#,.,#,.,#,.,#,.,.,.,.,#,#,#,#,#,#,#,#,#,#,.,#,#,#,#,#,#,#,#,#
#,.,.,.,#,.,.,.,#,.,#,.,.,.,#,.,.,.,.,.,.,.,#,.,#,.,.,.,.,.,#,.,.,.,.,.,.,.,#,.,#,.,.,.,#,.,.,.,.,.,.,.,#,.,.,.,.,.,.,.,.,.,#,.,.,.,.,.,#,.,.,.,#,.,#,.,.,.,#,.,.,.,.,.,.,.,.,.,#,.,#,.,.,.,.,.,.,.,.,.,#
#,.,#,.,#,.,#,.,.,.,#,.,#,.,#,.,#,#,#,.,#,.,#,.,#,.,#,#,#,#,#,.,#,.,#,#,#,#,#,.,.,#,#,#,#,#,#,#,#,.,#,#,#,.,#,#,#,#,#,#,#,.,#,.,.,#,#,.,#,.,#,#,.,.,#,.,#,.,#,#,.,.,#,#,#,#,#,.,#,.,#,#,#,.,#,#,#,#,#,.,#
#,.,.,.,.,.,#,.,.,.,#,.,#,.,#,.,#,.,.,.,#,.,#,.,#,.,#,.,.,.,.,.,#,.,#,.,.,.,#,.,.,.,.,.,.,.,.,.,.,.,.,.,.,.,#,.,.,.,.,.,.,.,#,.,#,.,.,.,#,.,.,.,.,.,#,.,#,.,.,.,.,.,#,.,.,.,#,.,.,.,#,.,#,.,.,.,.,.,#,.,#
#,.,#,#,#,#,#,.,#,#,#,.,#,.,#,.,#,.,#,.,#,.,#,.,.,.,#,.,#,#,#,#,#,.,#,.,#,#,#,.,#,#,.,#,#,.,#,#,#,#,#,.,#,#,#,#,#,#,#,.,#,#,#,.,#,.,#,#,#,.,#,.,#,#,#,.,#,#,#,#,#,#,#,.,#,.,#,#,#,.,#,.,.,.,#,.,#,.,#,.,#
#,.,#,.,.,.,#,.,.,.,.,.,#,.,#,.,#,.,#,.,#,.,#,.,.,.,#,.,#,.,.,.,.,.,.,.,#,.,.,.,#,.,.,.,.,.,.,.,.,.,.,.,#,.,.,.,.,.,#,.,.,.,#,.,#,.,.,.,#,.,#,.,.,.,.,.,#,.,.,.,.,.,#,.,#,.,#,.,.,.,#,.,#,.,#,.,#,.,#,.,#
#,#,#,.,#,.,#,#,#,#,.,.,#,#,#,.,#,.,.,.,#,.,#,#,#,#,#,#,#,.,#,#,.,#,#,.,#,.,#,#,#,.,#,.,#,.,#,#,#,#,#,#,#,.,#,#,#,.,#,#,#,.,#,.,#,#,#,.,#,.,#,#,#,#,#,#,#,.,#,.,#,#,#,.,#,.,#,.,#,.,#,.,#,.,#,.,#,.,#,.,#
#,.,.,.,#,.,.,.,.,.,.,.,#,.,.,.,#,.,#,.,#,.,.,.,.,.,.,.,.,.,#,.,.,.,#,.,.,.,#,.,#,.,#,.,.,.,.,.,.,.,.,.,.,.,#,.,#,.,.,.,#,.,#,.,#,.,.,.,.,.,.,.,#,.,.,.,.,.,#,.,#,.,.,.,#,.,#,.,.,.,.,.,#,.,#,.,.,.,.,.,#
#,.,#,.,#,#,#,#,#,#,#,.,#,.,#,#,#,#,#,.,#,.,#,#,#,#,#,#,#,#,#,.,.,.,#,.,#,#,#,.,#,.,.,#,#,.,#,#,#,.,#,.,#,#,#,.,#,#,#,.,.,.,#,.,#,.,#,#,#,#,#,.,#,.,#,#,#,.,#,#,#,.,#,#,#,.,#,#,#,#,#,.,#,.,#,#,#,#,#,.,#
#,.,#,.,#,.,.,.,#,.,.,.,.,.,.,.,.,.,.,.,#,.,.,.,#,.,.,.,.,.,#,.,#,.,#,.,.,.,#,.,#,.,.,.,.,.,#,.,#,.,#,.,#,.,#,.,.,.,.,.,#,.,.,.,#,.,#,.,.,.,#,.,#,.,#,.,.,.,#,.,.,.,#,.,#,.,#,.,.,.,#,.,.,.,.,.,.,.,#,.,#
#,.,#,#,#,.,#,.,#,#,#,#,#,#,#,#,#,#,#,.,#,#,#,.,#,#,#,.,#,.,#,#,#,.,#,#,#,.,#,.,#,#,#,#,#,#,#,.,#,.,#,.,#,.,#,.,.,#,#,#,#,#,#,.,#,.,#,.,#,.,#,.,#,#,#,.,#,.,#,.,#,#,#,.,#,.,#,#,#,.,#,.,#,.,.,.,#,.,#,#,#
#,.,.,.,#,.,#,.,.,.,#,.,.,.,.,.,.,.,.,.,#,.,.,.,#,.,.,.,.,.,.,.,.,.,.,.,#,.,.,.,#,.,.,.,.,.,.,.,#,.,.,.,#,.,#,.,.,.,#,.,.,.,.,.,#,.,#,.,#,.,#,.,.,.,.,.,.,.,#,.,.,.,#,.,#,.,.,.,#,.,.,.,#,.,.,.,#,.,.,.,#
#,.,.,.,#,.,#,#,#,.,#,.,#,#,#,#,#,.,#,#,#,.,#,#,#,.,#,#,.,.,.,#,#,#,#,#,#,#,#,.,#,#,#,.,#,#,#,#,#,#,#,#,#,.,#,.,#,.,#,#,#,.,#,#,#,.,#,#,#,.,#,#,#,#,#,.,#,#,#,#,#,.,#,.,#,#,.,.,#,.,.,#,#,#,.,#,#,.,#,.,#
#,.,#,.,#,.,.,.,#,.,.,.,.,.,#,.,.,.,.,.,.,.,#,.,.,.,#,.,.,.,#,.,.,.,.,.,.,.,#,.,.,.,.,.,#,.,.,.,.,.,.,.,.,.,.,.,#,.,.,.,.,.,#,.,#,.,.,.,#,.,.,.,.,.,.,.,#,.,.,.,.,.,#,.,#,.,.,.,#,.,.,.,.,.,.,.,.,.,#,.,#
#,#,.,.,#,#,#,.,#,#,#,#,#,#,#,.,#,#,#,#,#,#,#,.,#,.,#,.,#,#,#,.,.,#,#,.,#,#,#,.,#,#,#,#,#,.,#,#,#,#,.,.,#,.,#,#,#,.,#,.,.,#,#,.,#,#,#,.,#,#,#,#,#,#,.,#,.,.,#,#,#,#,#,.,#,.,#,#,#,.,#,#,#,#,#,.,#,.,#,.,#
#,.,.,.,.,.,#,.,.,.,.,.,#,.,.,.,#,.,.,.,.,.,.,.,#,.,#,.,#,.,.,.,#,.,.,.,#,.,.,.,#,.,.,.,.,.,.,.,#,.,.,.,#,.,#,.,.,.,.,.,.,.,.,.,.,.,#,.,.,.,#,.,.,.,.,.,.,.,#,.,.,.,#,.,#,.,#,.,.,.,.,.,.,.,.,.,.,.,#,.,#
#,.,#,.,#,.,#,.,#,#,#,#,#,.,.,.,#,#,#,#,#,#,#,#,#,.,#,#,#,.,#,#,#,.,.,.,#,.,#,#,#,.,#,#,#,#,#,#,#,.,#,#,#,#,#,.,#,#,#,#,#,#,#,.,#,.,#,#,#,.,.,.,#,#,#,#,#,#,#,.,#,.,#,.,#,.,#,#,#,.,#,#,#,#,#,.,#,#,.,.,#
#,.,.,.,#,.,.,.,#,.,.,.,#,.,#,.,#,.,.,.,.,.,.,.,#,.,.,.,.,.,#,.,#,.,#,.,#,.,.,.,#,.,.,.,.,.,.,.,#,.,.,.,.,.,#,.,.,.,.,.,#,.,#,.,#,.,.,.,#,.,.,.,.,.,.,.,.,.,.,.,.,.,.,.,#,.,.,.,#,.,.,.,#,.,.,.,#,.,.,.,#
#,.,#,.,#,.,#,#,#,.,#,.,#,.,#,.,#,.,#,#,#,#,.,.,#,#,#,.,#,.,#,.,.,.,#,#,#,#,#,.,#,.,#,.,#,#,#,.,#,.,#,.,#,.,#,.,#,.,#,.,#,.,#,.,#,#,#,#,#,#,#,#,#,#,#,.,#,.,#,.,#,.,.,#,#,#,#,.,#,.,#,.,#,#,.,.,#,.,#,#,#
#,.,#,.,#,.,.,.,.,.,#,.,#,.,#,.,#,.,.,.,#,.,#,.,.,.,.,.,#,.,.,.,#,.,.,.,.,.,.,.,#,.,#,.,#,.,.,.,.,.,#,.,#,.,#,.,.,.,#,.,.,.,#,.,.,.,#,.,.,.,.,.,.,.,#,.,#,.,#,.,#,.,#,.,.,.,#,.,.,.,#,.,.,.,#,.,#,.,.,.,#
#,#,#,.,#,.,#,.,#,#,#,.,#,.,#,.,#,#,#,.,#,.,#,#,.,#,#,.,#,#,.,#,#,#,#,.,.,#,#,#,#,.,#,.,.,#,#,#,#,.,#,.,#,.,#,.,#,#,#,.,#,#,#,#,#,.,.,.,#,.,#,#,#,.,#,#,#,.,.,.,#,.,#,.,#,.,#,#,#,#,#,#,#,.,#,.,#,#,#,.,#
#,.,.,.,#,.,#,.,.,.,#,.,.,.,#,.,#,.,#,.,.,.,.,.,.,.,#,.,.,.,.,.,.,.,.,.,.,.,.,.,.,.,#,.,.,.,#,.,.,.,#,.,#,.,.,.,#,.,.,.,.,.,.,.,#,.,#,.,#,.,.,.,#,.,.,.,.,.,#,.,.,.,.,.,#,.,.,.,#,.,.,.,#,.,.,.,.,.,.,.,#
#,.,#,#,#,.,#,#,#,.,#,#,#,#,#,.,#,.,#,#,#,.,#,.,#,.,#,.,#,.,.,#,#,#,#,#,#,#,#,#,#,#,#,#,#,.,#,.,#,#,#,.,#,.,#,#,#,.,#,#,#,#,#,.,#,.,#,.,#,#,#,.,#,#,#,#,#,#,#,.,#,#,.,.,#,#,#,.,#,.,#,.,#,#,#,#,#,#,#,.,#
#,.,#,.,.,.,#,.,#,.,#,.,.,.,.,.,.,.,#,.,.,.,.,.,#,.,.,.,#,.,.,.,.,.,#,.,.,.,.,.,.,.,#,.,.,.,#,.,#,.,.,.,#,.,.,.,#,.,#,.,.,.,.,.,#,.,#,.,.,.,#,.,.,.,.,.,.,.,#,.,#,.,.,.,#,.,.,.,#,.,#,.,.,.,.,.,.,.,#,.,#
#,.,.,.,#,#,#,.,#,.,#,#,#,#,#,#,#,.,#,.,.,#,#,#,#,.,.,.,#,#,.,#,.,.,.,#,#,#,#,.,#,.,#,.,#,#,#,#,#,.,#,#,#,.,#,#,#,.,#,#,#,#,#,.,#,.,#,#,.,.,#,#,#,#,#,#,#,.,#,.,#,.,#,#,#,.,#,#,#,.,.,.,#,#,#,#,#,#,#,.,#
#,.,#,.,#,.,.,.,#,.,.,.,.,.,.,.,#,.,#,.,#,.,#,.,.,.,#,.,.,.,.,.,#,.,.,.,.,.,.,.,#,.,#,.,.,.,.,.,.,.,.,.,.,.,#,.,.,.,#,.,.,.,#,.,#,.,.,.,.,.,#,.,.,.,.,.,#,.,.,.,.,.,#,.,.,.,#,.,.,.,#,.,.,.,#,.,.,.,.,.,#
#,.,#,.,#,#,#,.,#,#,#,.,#,.,#,.,#,#,#,.,#,.,.,.,#,#,#,#,#,#,.,#,#,#,#,.,.,.,#,#,#,.,#,#,#,#,#,#,#,#,#,.,.,#,#,.,#,#,#,.,#,.,#,.,#,#,#,#,#,.,#,.,#,#,#,.,#,#,#,#,#,.,#,.,#,#,#,.,#,#,#,#,#,.,.,.,#,#,#,#,#
#,.,.,.,#,.,.,.,.,.,.,.,#,.,#,.,.,.,#,.,.,.,#,.,.,.,#,.,.,.,.,.,.,.,.,.,#,.,.,.,#,.,#,.,.,.,.,.,.,.,#,.,.,.,#,.,.,.,.,.,#,.,.,.,.,.,.,.,#,.,.,.,.,.,.,.,#,.,.,.,.,.,.,.,#,.,.,.,#,.,.,.,#,.,#,.,.,.,.,.,#
#,.,#,#,.,.,#,.,#,.,#,.,#,.,#,#,#,.,#,#,#,.,#,#,#,.,#,.,#,#,#,#,#,#,#,.,#,.,.,.,.,.,#,.,.,#,#,.,#,.,#,#,#,.,#,#,#,.,#,#,#,.,#,#,.,#,#,.,#,#,#,#,#,.,.,.,#,.,#,.,#,#,#,#,#,.,.,#,#,.,#,#,#,.,#,.,#,.,#,.,#
#,.,.,.,.,.,#,.,#,.,#,.,.,.,#,.,#,.,.,.,#,.,#,.,.,.,#,.,#,.,.,.,.,.,#,.,.,.,#,.,#,.,#,.,#,.,.,.,#,.,.,.,#,.,.,.,.,.,#,.,.,.,#,.,.,.,#,.,.,.,.,.,.,.,#,.,#,.,#,.,#,.,.,.,.,.,#,.,.,.,#,.,.,.,#,.,.,.,#,.,#
#,#,#,#,#,#,#,.,#,.,#,#,#,.,.,.,#,#,#,.,#,.,#,.,#,#,#,.,#,.,#,#,#,.,#,.,#,.,#,.,#,#,#,.,#,.,#,#,#,#,#,.,#,.,#,.,#,#,#,.,#,.,#,.,#,.,#,#,#,#,#,#,.,.,#,#,#,.,#,.,#,.,#,.,#,.,#,.,#,#,#,.,#,.,#,#,#,#,#,.,#
#,.,.,.,.,.,#,.,#,.,.,.,#,.,#,.,.,.,#,.,.,.,#,.,.,.,.,.,#,.,.,.,#,.,.,.,.,.,#,.,.,.,.,.,#,.,#,.,.,.,#,.,.,.,#,.,.,.,#,.,#,.,#,.,#,.,.,.,.,.,.,.,#,.,.,.,.,.,#,.,#,.,#,.,.,.,#,.,.,.,.,.,.,.,.,.,#,.,.,.,#
#,.,#,#,#,.,#,.,#,#,#,.,#,.,#,#,#,.,#,#,#,#,#,#,#,#,#,#,#,.,#,#,#,#,#,.,#,#,#,#,#,#,#,#,#,.,#,.,#,.,#,#,#,.,#,.,.,.,#,.,#,#,#,.,#,#,#,#,#,#,#,.,#,.,#,.,.,.,#,#,#,.,#,#,#,#,#,.,#,.,#,#,#,.,#,.,#,.,#,#,#
#,.,#,.,.,.,#,.,#,.,.,.,#,.,.,.,.,.,#,.,.,.,.,.,.,.,.,.,.,.,#,.,.,.,#,.,#,.,.,.,.,.,.,.,#,.,#,.,#,.,#,.,.,.,#,.,#,.,#,.,#,.,.,.,#,.,#,.,.,.,.,.,#,.,.,.,.,.,#,.,.,.,#,.,.,.,.,.,#,.,.,.,.,.,#,.,.,.,#,.,#
#,.,#,.,#,#,#,.,#,.,#,.,#,#,#,#,#,.,#,.,.,#,#,.,#,.,#,.,#,#,#,.,#,.,#,#,#,.,.,#,#,#,#,.,#,.,#,.,#,.,.,.,#,#,#,#,#,.,#,.,.,.,#,.,#,.,#,.,#,#,#,#,#,#,#,.,#,#,#,.,.,#,#,.,.,.,#,.,#,#,#,#,#,.,#,.,#,.,#,.,#
#,.,#,.,.,.,.,.,#,.,.,.,.,.,.,.,.,.,.,.,#,.,.,.,.,.,#,.,.,.,.,.,#,.,.,.,.,.,#,.,.,.,.,.,.,.,#,.,#,.,.,.,.,.,.,.,.,.,#,.,.,.,.,.,.,.,#,.,.,.,.,.,.,.,.,.,.,.,.,.,.,.,.,.,#,.,.,.,.,.,.,.,#,.,.,.,.,.,.,G,#
#,#,#,#,#,#,#,#,#,#,#,#,#,#,#,#,#,#,#,#,#,#,#,#,#,#,#,#,#,#,#,#,#,#,#,#,#,#,#,#,#,#,#,#,#,#,#,#,#,#,#,#,#,#,#,#,#,#,#,#,#,#,#,#,#,#,#,#,#,#,#,#,#,#,#,#,#,#,#,#,#,#,#,#,#,#,#,#,#,#,#,#,#,#,#,#,#,#,#,#,#
