#,#,#,#,#,#,#,#,#,#,#,#,#,#,#,#,#,#,#
#,S,#,.,.,.,.,.,.,.,.,.,.,.,.,.,.,.,#
#,.,#,.,.,#,#,#,#,#,#,#,#,.,#,#,#,#,#
#,.,#,.,.,.,.,.,.,.,.,.,#,.,.,.,.,.,#
#,.,.,#,#,#,#,#,#,#,#,.,#,#,#,#,#,.,#
#,.,.,.,.,.,#,.,.,.,.,.,#,.,.,.,#,.,#
#,#,#,#,#,.,#,.,#,#,#,#,#,.,#,.,#,.,#
#,.,.,.,#,.,#,.,.,.,#,.,.,.,.,.,#,.,#
#,.,#,#,#,.,#,#,#,.,#,.,.,.,#,.,#,.,#
#,.,.,.,.,.,#,.,.,.,.,.,#,.,#,.,.,.,#
#,.,#,#,#,#,#,#,#,#,#,#,#,#,#,.,#,#,#
#,.,#,.,.,.,.,.,.,.,.,.,.,.,#,.,.,.,#
#,.,#,.,#,#,#,.,#,#,#,.,#,.,#,.,#,.,#
#,.,#,.,.,.,#,.,.,.,#,.,.,.,.,.,#,.,#
#,.,#,#,#,#,#,.,#,.,#,.,#,.,#,.,#,.,#
#,.,.,.,.,.,.,.,#,.,#,.,.,.,#,.,#,.,#
#,.,#,.,#,.,#,#,#,.,#,#,#,.,#,#,#,.,#
#,.,.,.,#,.,.,.,.,.,#,.,.,.,.,.,.,G,#
#,#,#,#,#,#,#,#,#,#,#,#,#,#,#,#,#,#,#
