#,#,#,#,#,#,#,#,#,#,#,#,#,#,#,#,#,#,#,#,#,#,#,#,#,#,#,#,#,#,#,#,#,#,#,#,#,#,#,#,#,#,#,#,#,#,#,#,#,#,#,#,#,#,#,#,#,#,#,#,#,#,#,#,#,#,#,#,#,#,#,#,#,#,#,#,#,#,#,#,#,#,#,#,#,#,#,#,#
#,S,.,.,.,.,.,.,.,.,.,.,#,.,.,.,.,.,#,.,.,.,.,.,#,.,.,.,.,.,.,.,.,.,.,.,#,.,.,.,.,.,#,.,.,.,.,.,.,.,.,.,#,.,.,.,.,.,#,.,.,.,.,.,.,.,.,.,.,.,.,.,#,.,.,.,.,.,.,.,#,.,.,.,.,.,#,.,#
#,#,#,#,#,#,#,#,#,#,#,.,#,.,#,#,#,.,#,.,#,#,#,#,#,.,#,#,#,#,#,.,#,#,#,.,#,.,#,#,#,.,#,.,#,.,#,#,#,#,#,#,#,.,#,.,#,.,#,#,#,#,#,#,#,#,#,.,#,.,#,.,#,#,#,#,#,.,#,.,#,#,#,.,#,.,#,.,#
#,.,.,.,.,.,#,.,.,.,.,.,#,.,.,.,#,.,#,.,#,.,.,.,#,.,.,.,#,.,#,.,#,.,#,.,#,.,#,.,#,.,#,.,#,.,#,.,.,.,.,.,.,.,#,.,#,.,.,.,.,.,.,.,.,.,#,.,#,.,#,.,.,.,.,.,.,.,#,.,.,.,#,.,#,.,.,.,#
#,.,#,.,#,#,#,.,#,#,#,#,#,#,#,.,#,.,#,.,#,.,#,.,#,#,#,.,#,.,#,.,#,.,#,.,#,.,#,.,#,.,#,.,#,.,#,.,#,#,#,#,#,#,#,.,#,#,#,#,#,#,#,#,#,.,#,#,#,.,#,#,#,#,#,#,#,#,#,#,#,.,#,.,#,#,#,.,#
#,.,#,.,#,.,.,.,#,.,.,.,.,.,.,.,#,.,#,.,#,.,#,.,.,.,.,.,.,.,#,.,#,.,#,.,.,.,#,.,.,.,#,.,#,.,.,.,.,.,.,.,#,.,.,.,#,.,.,.,.,.,.,.,#,.,.,.,#,.,.,.,#,.,.,.,#,.,.,.,#,.,#,.,.,.,#,.,#
#,#,#,.,#,.,#,#,#,.,#,#,#,#,#,#,#,.,#,.,#,.,#,#,#,#,#,#,#,#,#,.,#,.,#,#,#,#,#,.,#,#,#,#,#,.,#,#,#,#,#,#,#,.,#,#,#,.,#,#,#,#,#,.,#,#,#,.,#,.,#,.,#,.,#,.,#,.,#,.,#,.,#,#,#,.,#,.,#
#,.,.,.,#,.,#,.,.,.,#,.,.,.,.,.,#,.,#,.,.,.,.,.,#,.,.,.,.,.,#,.,#,.,.,.,.,.,#,.,.,.,.,.,#,.,#,.,.,.,.,.,.,.,#,.,.,.,.,.,#,.,.,.,.,.,#,.,#,.,#,.,.,.,#,.,#,.,#,.,#,.,#,.,.,.,#,.,#
#,.,#,.,#,.,#,#,#,.,#,.,#,#,#,.,#,.,#,#,#,#,#,#,#,.,#,#,#,.,#,.,#,.,#,.,#,#,#,#,#,#,#,.,#,#,#,.,#,#,#,#,#,#,#,#,#,#,#,#,#,.,#,#,#,.,#,.,#,.,#,#,#,#,#,.,#,.,#,#,#,.,#,.,#,#,#,.,#
#,.,#,.,#,.,#,.,.,.,#,.,.,.,#,.,.,.,#,.,.,.,.,.,.,.,#,.,#,.,.,.,#,.,#,.,.,.,.,.,.,.,#,.,.,.,#,.,.,.,#,.,.,.,.,.,.,.,.,.,.,.,#,.,#,.,#,.,#,.,#,.,#,.,.,.,#,.,.,.,.,.,#,.,#,.,.,.,#
#,.,#,#,#,.,#,.,#,#,#,#,#,.,#,#,#,#,#,.,#,#,#,#,#,#,#,.,#,#,#,#,#,.,#,#,#,.,#,#,#,.,#,#,#,.,#,#,#,.,#,#,#,#,#,.,#,#,#,#,#,#,#,.,#,.,#,.,#,.,#,.,#,.,#,#,#,#,#,#,#,.,#,.,#,#,#,.,#
#,.,.,.,#,.,.,.,#,.,.,.,#,.,#,.,.,.,.,.,#,.,.,.,#,.,.,.,.,.,.,.,.,.,#,.,.,.,#,.,.,.,#,.,#,.,#,.,.,.,#,.,.,.,.,.,#,.,.,.,.,.,.,.,#,.,#,.,#,.,#,.,#,.,.,.,.,.,.,.,#,.,#,.,.,.,#,.,#
#,#,#,.,#,#,#,#,#,.,#,.,#,.,#,.,#,#,#,#,#,.,#,.,#,#,#,#,#,#,#,#,#,#,#,.,#,#,#,#,#,.,#,.,#,.,#,.,#,#,#,.,#,#,#,#,#,.,#,#,#,.,#,#,#,.,#,.,#,.,#,.,#,#,#,#,#,#,#,.,#,.,#,#,#,.,#,.,#
#,.,.,.,.,.,.,.,#,.,#,.,#,.,#,.,#,.,.,.,.,.,#,.,.,.,.,.,.,.,.,.,.,.,#,.,#,.,.,.,#,.,.,.,#,.,.,.,#,.,.,.,.,.,#,.,.,.,#,.,#,.,#,.,.,.,#,.,#,.,.,.,.,.,#,.,.,.,#,.,#,.,.,.,#,.,#,.,#
#,.,#,#,#,#,#,.,#,.,#,.,#,.,#,.,#,.,#,.,#,#,#,#,#,#,#,#,#,#,#,#,#,.,#,.,#,.,#,.,#,#,#,#,#,#,#,#,#,#,#,.,#,.,#,.,#,#,#,.,#,.,#,.,#,#,#,.,#,#,#,#,#,.,#,#,#,.,#,.,#,#,#,.,#,.,#,.,#
#,.,.,.,#,.,.,.,#,.,#,.,#,.,.,.,#,.,#,.,#,.,.,.,.,.,.,.,#,.,.,.,.,.,#,.,#,.,#,.,.,.,.,.,.,.,.,.,.,.,#,.,#,.,#,.,.,.,.,.,#,.,.,.,.,.,#,.,#,.,.,.,.,.,.,.,.,.,#,.,.,.,#,.,.,.,#,.,#
#,.,#,.,#,#,#,.,#,#,#,.,#,#,#,#,#,.,#,#,#,.,#,#,#,#,#,.,#,#,#,.,#,#,#,.,#,.,#,#,#,#,#,#,#,#,#,.,#,.,#,.,#,.,#,#,#,#,#,#,#,#,#,#,#,#,#,.,#,#,#,#,#,#,#,#,#,.,#,#,#,.,#,#,#,#,#,.,#
#,.,#,.,.,.,#,.,.,.,.,.,.,.,.,.,.,.,#,.,.,.,#,.,.,.,#,.,.,.,#,.,.,.,#,.,#,.,.,.,#,.,.,.,#,.,.,.,#,.,#,.,#,.,.,.,.,.,.,.,.,.,.,.,.,.,#,.,.,.,.,.,.,.,.,.,#,.,#,.,.,.,#,.,.,.,#,.,#
#,.,#,#,#,.,#,#,#,#,#,.,#,#,#,#,#,#,#,.,#,#,#,#,#,.,#,#,#,.,#,#,#,.,#,.,#,#,#,.,#,.,#,#,#,.,#,#,#,.,#,.,#,#,#,#,#,#,#,#,#,#,#,#,#,.,#,#,#,#,#,#,#,#,#,.,#,#,#,.,#,#,#,.,#,.,#,.,#
#,.,.,.,#,.,.,.,#,.,#,.,#,.,.,.,#,.,.,.,#,.,.,.,#,.,.,.,#,.,#,.,.,.,#,.,#,.,.,.,#,.,#,.,.,.,#,.,.,.,#,.,#,.,.,.,.,.,.,.,.,.,.,.,#,.,.,.,.,.,#,.,.,.,.,.,#,.,.,.,#,.,#,.,#,.,.,.,#
#,#,#,#,#,#,#,.,#,.,#,.,#,.,#,.,#,.,#,#,#,.,#,.,#,.,#,#,#,.,#,.,#,#,#,.,#,.,#,#,#,.,#,.,#,#,#,.,#,#,#,.,#,#,#,.,#,.,#,#,#,#,#,.,#,#,#,.,#,#,#,.,#,#,#,#,#,.,#,#,#,.,#,.,#,#,#,#,#
#,.,.,.,.,.,.,.,#,.,.,.,#,.,#,.,#,.,#,.,.,.,#,.,.,.,#,.,.,.,#,.,.,.,.,.,#,.,#,.,.,.,#,.,#,.,.,.,#,.,.,.,.,.,#,.,#,.,.,.,#,.,.,.,.,.,#,.,#,.,.,.,#,.,.,.,.,.,#,.,.,.,#,.,#,.,.,.,#
#,.,#,#,#,#,#,.,#,#,#,#,#,.,#,.,#,.,#,#,#,.,#,#,#,#,#,.,#,#,#,.,#,#,#,#,#,.,#,.,#,#,#,.,#,.,#,#,#,#,#,#,#,.,#,#,#,#,#,.,#,#,#,#,#,#,#,.,#,.,#,#,#,#,#,.,#,#,#,.,#,.,#,.,#,.,#,.,#
#,.,#,.,.,.,#,.,#,.,.,.,.,.,#,.,#,.,.,.,#,.,#,.,.,.,.,.,#,.,#,.,#,.,.,.,.,.,#,.,.,.,#,.,#,.,.,.,.,.,.,.,#,.,.,.,.,.,.,.,#,.,.,.,.,.,#,.,#,.,#,.,.,.,.,.,#,.,.,.,#,.,#,.,#,.,#,.,#
#,.,#,.,#,.,#,#,#,.,#,#,#,#,#,.,#,#,#,.,#,.,#,.,#,#,#,#,#,.,#,.,#,.,#,#,#,#,#,.,#,.,#,.,#,#,#,#,#,#,#,.,#,#,#,#,#,.,#,#,#,.,#,#,#,.,#,.,#,.,#,.,#,#,#,#,#,.,#,.,#,#,#,.,#,.,#,.,#
#,.,.,.,#,.,.,.,.,.,#,.,.,.,.,.,#,.,#,.,.,.,#,.,.,.,#,.,.,.,.,.,#,.,#,.,.,.,.,.,#,.,#,.,#,.,.,.,.,.,#,.,.,.,#,.,.,.,#,.,.,.,#,.,#,.,.,.,#,.,#,.,.,.,#,.,.,.,#,.,.,.,#,.,#,.,#,.,#
#,.,#,#,#,#,#,#,#,#,#,.,#,#,#,.,#,.,#,#,#,.,#,#,#,.,#,.,#,#,#,#,#,.,#,.,#,#,#,#,#,.,#,.,#,.,#,#,#,#,#,#,#,.,#,#,#,.,#,.,#,#,#,.,#,#,#,.,#,.,#,.,#,.,#,#,#,#,#,#,#,.,#,.,#,#,#,.,#
#,.,.,.,.,.,.,.,.,.,#,.,.,.,#,.,.,.,#,.,.,.,#,.,.,.,#,.,#,.,.,.,#,.,#,.,#,.,.,.,#,.,#,.,#,.,.,.,.,.,.,.,.,.,.,.,#,.,#,.,#,.,.,.,.,.,.,.,#,.,#,.,#,.,.,.,.,.,#,.,.,.,#,.,#,.,.,.,#
#,#,#,#,#,#,#,#,#,.,#,#,#,.,#,#,#,#,#,.,#,#,#,.,#,#,#,#,#,.,#,.,#,.,#,.,#,.,#,#,#,.,#,.,#,#,#,#,#,#,#,#,#,#,#,.,#,#,#,.,#,#,#,#,#,#,#,#,#,.,#,#,#,#,#,#,#,.,#,.,#,.,#,.,#,.,#,.,#
#,.,.,.,.,.,.,.,#,.,#,.,#,.,.,.,.,.,.,.,#,.,.,.,#,.,.,.,.,.,#,.,.,.,#,.,#,.,.,.,#,.,#,.,.,.,.,.,.,.,.,.,#,.,.,.,.,.,#,.,#,.,.,.,.,.,.,.,#,.,#,.,.,.,.,.,#,.,#,.,#,.,#,.,#,.,#,.,#
#,.,#,#,#,#,#,#,#,.,#,.,#,#,#,#,#,#,#,#,#,.,#,.,#,.,#,#,#,#,#,#,#,#,#,.,#,.,#,.,#,.,#,#,#,#,#,#,#,#,#,.,#,#,#,#,#,.,#,.,#,.,#,#,#,#,#,.,#,.,#,.,#,#,#,.,#,.,#,.,#,#,#,.,#,.,#,.,#
#,.,.,.,.,.,.,.,.,.,#,.,.,.,.,.,#,.,.,.,.,.,#,.,#,.,.,.,.,.,.,.,#,.,#,.,#,.,#,.,#,.,.,.,.,.,#,.,.,.,#,.,.,.,#,.,.,.,.,.,#,.,.,.,#,.,#,.,#,.,#,.,#,.,.,.,.,.,#,.,.,.,.,.,.,.,#,.,#
#,.,#,#,#,#,#,#,#,#,#,.,#,#,#,#,#,.,#,.,#,#,#,#,#,#,#,#,#,#,#,.,#,.,#,.,#,#,#,.,#,#,#,.,#,.,#,#,#,.,#,#,#,.,#,#,#,.,#,#,#,#,#,.,#,.,#,.,#,.,#,.,#,#,#,#,#,#,#,#,#,#,#,#,#,#,#,#,#
#,.,#,.,.,.,.,.,#,.,.,.,#,.,.,.,#,.,#,.,#,.,.,.,.,.,#,.,.,.,#,.,#,.,#,.,.,.,.,.,#,.,.,.,#,.,.,.,.,.,#,.,#,.,.,.,#,.,#,.,.,.,.,.,.,.,#,.,#,.,#,.,.,.,.,.,.,.,.,.,.,.,.,.,.,.,.,.,#
#,.,#,.,#,#,#,.,#,.,#,.,#,.,#,.,#,.,#,#,#,.,#,.,#,.,#,#,#,.,#,.,#,.,#,#,#,#,#,.,#,.,#,#,#,#,#,#,#,.,#,.,#,#,#,.,#,#,#,.,#,#,#,#,#,#,#,.,#,.,#,#,#,#,#,.,#,#,#,#,#,#,#,#,#,#,#,.,#
#,.,.,.,#,.,#,.,#,.,#,.,.,.,#,.,#,.,.,.,#,.,#,.,#,.,.,.,.,.,#,.,#,.,.,.,.,.,#,.,#,.,#,.,#,.,.,.,.,.,#,.,.,.,#,.,.,.,.,.,#,.,.,.,#,.,.,.,#,.,.,.,.,.,#,.,.,.,.,.,.,.,#,.,.,.,#,.,#
#,#,#,#,#,.,#,.,#,#,#,#,#,.,#,.,#,#,#,.,#,.,#,.,#,.,#,#,#,#,#,.,#,#,#,#,#,.,#,.,#,.,#,.,#,.,#,#,#,#,#,#,#,.,#,#,#,#,#,#,#,.,#,.,#,.,#,#,#,#,#,#,#,.,#,#,#,#,#,#,#,.,#,.,#,.,#,.,#
#,.,.,.,.,.,#,.,.,.,.,.,#,.,#,.,.,.,#,.,.,.,#,.,#,.,#,.,.,.,#,.,.,.,.,.,#,.,.,.,#,.,#,.,.,.,#,.,.,.,.,.,#,.,.,.,.,.,#,.,.,.,#,.,.,.,#,.,.,.,#,.,.,.,#,.,#,.,.,.,#,.,.,.,#,.,#,.,#
#,.,#,#,#,.,#,#,#,#,#,.,#,#,#,#,#,.,#,#,#,#,#,.,#,#,#,.,#,.,#,#,#,#,#,.,#,#,#,#,#,.,#,.,#,#,#,.,#,#,#,.,#,#,#,#,#,.,#,.,#,.,#,#,#,#,#,.,#,.,#,.,#,#,#,.,#,.,#,.,#,#,#,.,#,#,#,.,#
#,.,#,.,.,.,#,.,.,.,#,.,.,.,.,.,.,.,.,.,#,.,#,.,#,.,.,.,#,.,.,.,.,.,#,.,#,.,.,.,#,.,#,.,.,.,#,.,.,.,#,.,#,.,.,.,.,.,#,.,#,.,#,.,.,.,.,.,#,.,#,.,#,.,.,.,#,.,#,.,.,.,.,.,#,.,.,.,#
#,#,#,.,#,.,#,.,#,.,#,#,#,#,#,#,#,#,#,.,#,.,#,.,#,.,#,#,#,#,#,.,#,#,#,.,#,.,#,.,#,.,#,#,#,.,#,#,#,.,#,.,#,.,#,#,#,.,#,.,#,#,#,.,#,#,#,#,#,.,#,.,#,.,#,#,#,.,#,#,#,#,#,#,#,.,#,#,#
#,.,.,.,#,.,#,.,#,.,.,.,.,.,#,.,.,.,.,.,#,.,#,.,.,.,#,.,.,.,#,.,.,.,#,.,.,.,#,.,#,.,#,.,.,.,#,.,.,.,#,.,.,.,#,.,.,.,#,.,.,.,#,.,#,.,.,.,#,.,.,.,#,.,.,.,#,.,.,.,.,.,.,.,#,.,.,.,#
#,.,#,#,#,.,#,#,#,#,#,.,#,.,#,.,#,#,#,#,#,.,#,#,#,#,#,.,#,.,#,#,#,.,#,#,#,#,#,.,#,.,#,#,#,.,#,.,#,#,#,#,#,#,#,.,#,#,#,#,#,.,#,.,#,.,#,.,#,#,#,#,#,.,#,.,#,#,#,.,#,#,#,#,#,#,#,.,#
#,.,#,.,#,.,.,.,.,.,#,.,#,.,#,.,#,.,.,.,.,.,.,.,#,.,.,.,#,.,.,.,#,.,.,.,.,.,#,.,#,.,.,.,#,.,#,.,.,.,.,.,#,.,.,.,#,.,.,.,#,.,.,.,#,.,#,.,.,.,.,.,#,.,#,.,.,.,#,.,#,.,.,.,.,.,.,.,#
#,.,#,.,#,#,#,#,#,.,#,.,#,#,#,.,#,.,#,#,#,#,#,.,#,#,#,#,#,.,#,#,#,#,#,#,#,.,#,.,#,#,#,.,#,.,#,#,#,#,#,.,#,.,#,#,#,.,#,#,#,#,#,#,#,#,#,#,#,.,#,.,#,.,#,#,#,.,#,.,#,.,#,#,#,#,#,.,#
#,.,#,.,.,.,.,.,#,.,#,.,#,.,.,.,#,.,.,.,#,.,#,.,.,.,.,.,#,.,.,.,.,.,.,.,#,.,.,.,#,.,.,.,#,.,#,.,.,.,.,.,#,.,#,.,.,.,.,.,.,.,.,.,.,.,.,.,#,.,#,.,#,.,.,.,#,.,.,.,#,.,#,.,.,.,.,.,#
#,.,#,.,#,#,#,.,#,.,#,.,#,.,#,#,#,#,#,.,#,.,#,#,#,#,#,.,#,#,#,#,#,#,#,.,#,#,#,#,#,.,#,#,#,.,#,.,#,#,#,#,#,.,#,#,#,#,#,#,#,#,#,#,#,.,#,.,#,.,#,.,#,#,#,#,#,#,#,.,#,.,#,#,#,.,#,#,#
#,.,#,.,.,.,#,.,#,.,#,.,#,.,.,.,#,.,.,.,#,.,.,.,.,.,#,.,.,.,#,.,.,.,.,.,.,.,#,.,.,.,#,.,.,.,#,.,#,.,.,.,.,.,.,.,.,.,.,.,.,.,#,.,.,.,#,.,.,.,#,.,.,.,.,.,.,.,#,.,#,.,.,.,#,.,#,.,#
#,.,#,.,#,.,#,.,#,.,#,.,#,#,#,.,#,.,#,#,#,.,#,.,#,#,#,#,#,.,#,.,#,#,#,#,#,.,#,.,#,.,#,.,#,#,#,.,#,#,#,.,#,#,#,#,#,#,#,#,#,.,#,.,#,#,#,#,#,#,#,#,#,#,#,#,#,.,#,#,#,#,#,.,#,.,#,.,#
#,.,#,.,#,.,#,.,#,.,#,.,.,.,#,.,.,.,#,.,.,.,#,.,.,.,.,.,#,.,#,.,.,.,.,.,#,.,#,.,#,.,#,.,.,.,#,.,.,.,#,.,#,.,.,.,#,.,.,.,.,.,.,.,#,.,.,.,.,.,.,.,.,.,.,.,#,.,.,.,#,.,.,.,#,.,.,.,#
#,.,#,#,#,.,#,#,#,.,#,#,#,.,#,#,#,#,#,.,#,#,#,#,#,#,#,.,#,.,#,#,#,#,#,.,#,.,#,.,#,.,#,#,#,.,#,#,#,.,#,#,#,.,#,.,#,#,#,#,#,#,#,#,#,.,#,#,#,#,#,#,#,#,#,#,#,#,#,.,#,.,#,#,#,#,#,#,#
#,.,.,.,#,.,.,.,#,.,.,.,#,.,#,.,.,.,#,.,.,.,#,.,.,.,.,.,#,.,.,.,.,.,.,.,#,.,#,.,#,.,.,.,#,.,.,.,#,.,.,.,#,.,#,.,.,.,.,.,#,.,.,.,.,.,.,.,.,.,.,.,.,.,#,.,.,.,.,.,#,.,.,.,.,.,.,.,#
#,.,#,.,#,.,#,.,#,#,#,.,#,.,#,.,#,.,#,#,#,.,#,.,#,#,#,.,#,#,#,#,#,#,#,#,#,.,#,.,#,#,#,.,#,#,#,.,#,.,#,.,#,.,#,#,#,#,#,.,#,#,#,.,#,#,#,#,#,#,#,#,#,.,#,.,#,#,#,#,#,#,#,#,#,#,#,.,#
#,.,#,.,#,.,#,.,.,.,#,.,#,.,.,.,#,.,.,.,#,.,#,.,#,.,#,.,#,.,#,.,.,.,.,.,#,.,#,.,.,.,#,.,#,.,#,.,#,.,#,.,.,.,.,.,.,.,#,.,.,.,#,.,#,.,.,.,.,.,#,.,.,.,#,.,#,.,.,.,.,.,.,.,.,.,#,.,#
#,#,#,.,#,.,#,#,#,.,#,.,#,.,#,#,#,#,#,.,#,.,#,.,#,.,#,.,#,.,#,.,#,#,#,.,#,.,#,#,#,#,#,.,#,.,#,.,#,.,#,#,#,#,#,#,#,#,#,#,#,.,#,.,#,.,#,#,#,.,#,.,#,#,#,.,#,.,#,#,#,#,#,#,#,.,#,.,#
#,.,.,.,#,.,.,.,#,.,#,.,#,.,#,.,.,.,#,.,#,.,#,.,#,.,#,.,#,.,.,.,#,.,.,.,#,.,.,.,.,.,.,.,#,.,.,.,#,.,#,.,.,.,.,.,.,.,.,.,.,.,#,.,#,.,.,.,#,.,.,.,#,.,.,.,#,.,#,.,.,.,.,.,.,.,#,.,#
#,.,#,#,#,#,#,.,#,.,#,.,#,#,#,.,#,.,#,.,#,.,#,.,#,.,#,.,#,#,#,#,#,.,#,.,#,#,#,#,#,#,#,#,#,.,#,#,#,.,#,.,#,#,#,#,#,#,#,#,#,#,#,.,#,#,#,.,#,#,#,#,#,.,#,#,#,.,#,#,#,.,#,#,#,#,#,.,#
#,.,#,.,.,.,.,.,#,.,.,.,.,.,#,.,#,.,.,.,#,.,#,.,#,.,.,.,.,.,.,.,.,.,#,.,.,.,.,.,.,.,.,.,#,.,#,.,.,.,#,.,.,.,#,.,.,.,.,.,.,.,#,.,#,.,#,.,.,.,.,.,#,.,.,.,#,.,.,.,#,.,.,.,.,.,#,.,#
#,.,#,#,#,#,#,#,#,#,#,#,#,.,#,.,#,.,#,#,#,.,#,.,#,#,#,#,#,#,#,#,#,#,#,#,#,#,#,#,#,#,#,.,#,.,#,#,#,#,#,#,#,.,#,.,#,#,#,#,#,.,#,.,#,.,#,#,#,#,#,.,#,#,#,.,#,#,#,.,#,#,#,#,#,.,#,.,#
#,.,.,.,#,.,.,.,.,.,#,.,.,.,.,.,#,.,#,.,.,.,#,.,.,.,.,.,#,.,.,.,.,.,.,.,.,.,#,.,#,.,.,.,#,.,.,.,.,.,.,.,#,.,#,.,#,.,.,.,.,.,#,.,#,.,.,.,.,.,#,.,.,.,#,.,.,.,.,.,#,.,.,.,#,.,#,.,#
#,.,#,.,#,.,#,#,#,.,#,#,#,#,#,#,#,#,#,.,#,#,#,#,#,#,#,.,#,.,#,#,#,#,#,#,#,.,#,.,#,.,#,#,#,#,#,#,#,#,#,.,#,.,#,.,#,.,#,#,#,#,#,.,#,#,#,#,#,.,#,#,#,.,#,#,#,#,#,#,#,.,#,#,#,.,#,.,#
#,.,#,.,.,.,#,.,#,.,#,.,.,.,.,.,.,.,.,.,#,.,.,.,.,.,#,.,#,.,#,.,.,.,.,.,#,.,#,.,.,.,#,.,.,.,.,.,.,.,.,.,#,.,#,.,#,.,#,.,.,.,.,.,.,.,.,.,#,.,.,.,#,.,.,.,.,.,.,.,.,.,.,.,#,.,#,.,#
#,.,#,#,#,#,#,.,#,.,#,.,#,#,#,#,#,#,#,#,#,.,#,.,#,.,#,.,#,.,#,#,#,#,#,.,#,.,#,#,#,#,#,.,#,#,#,#,#,#,#,#,#,.,#,.,#,.,#,#,#,#,#,#,#,#,#,.,#,.,#,#,#,#,#,#,#,#,#,#,#,#,#,.,#,.,#,.,#
#,.,.,.,#,.,.,.,#,.,.,.,#,.,#,.,.,.,.,.,.,.,#,.,#,.,#,.,#,.,.,.,#,.,.,.,#,.,.,.,#,.,.,.,#,.,.,.,.,.,.,.,.,.,#,.,#,.,#,.,.,.,#,.,.,.,#,.,.,.,#,.,.,.,.,.,#,.,.,.,.,.,#,.,.,.,.,.,#
#,#,#,.,#,#,#,.,#,#,#,#,#,.,#,.,#,#,#,#,#,#,#,.,#,#,#,.,#,#,#,.,#,.,#,.,#,#,#,.,#,.,#,#,#,.,#,#,#,.,#,#,#,#,#,.,#,.,#,.,#,.,#,.,#,.,#,#,#,#,#,.,#,#,#,.,#,.,#,#,#,.,#,#,#,#,#,#,#
#,.,#,.,.,.,.,.,.,.,.,.,#,.,.,.,.,.,#,.,.,.,.,.,#,.,.,.,.,.,#,.,#,.,#,.,.,.,#,.,.,.,#,.,.,.,.,.,#,.,.,.,#,.,.,.,#,.,#,.,#,.,#,.,#,.,.,.,.,.,.,.,.,.,#,.,#,.,.,.,#,.,.,.,.,.,.,.,#
#,.,#,#,#,#,#,#,#,#,#,.,#,.,#,#,#,#,#,.,#,#,#,.,#,.,#,#,#,#,#,.,#,.,#,#,#,.,#,#,#,#,#,#,#,#,#,.,#,#,#,.,#,.,#,#,#,.,#,.,#,.,#,.,#,#,#,#,#,#,#,#,#,.,#,.,#,#,#,.,#,#,#,#,#,#,#,.,#
#,.,.,.,.,.,#,.,.,.,#,.,#,.,.,.,#,.,.,.,#,.,.,.,#,.,.,.,.,.,.,.,#,.,.,.,#,.,#,.,.,.,.,.,#,.,#,.,.,.,#,.,.,.,.,.,#,.,.,.,#,.,.,.,#,.,.,.,.,.,#,.,.,.,#,.,.,.,#,.,.,.,.,.,#,.,.,.,#
#,.,#,#,#,.,#,#,#,.,#,.,#,#,#,.,#,.,#,#,#,#,#,#,#,#,#,#,#,#,#,#,#,.,#,.,#,.,#,#,#,.,#,.,#,.,#,#,#,.,#,#,#,#,#,#,#,.,#,#,#,#,#,#,#,.,#,#,#,.,#,.,#,#,#,.,#,#,#,#,#,#,#,.,#,.,#,.,#
#,.,#,.,.,.,.,.,.,.,#,.,.,.,#,.,#,.,.,.,.,.,#,.,.,.,.,.,.,.,.,.,#,.,#,.,#,.,.,.,.,.,#,.,#,.,.,.,.,.,#,.,.,.,.,.,#,.,.,.,.,.,#,.,.,.,#,.,#,.,#,.,.,.,#,.,.,.,.,.,.,.,#,.,#,.,#,.,#
#,.,#,#,#,#,#,#,#,#,#,#,#,.,#,#,#,.,#,#,#,.,#,.,#,#,#,#,#,.,#,.,#,#,#,.,#,#,#,#,#,#,#,.,#,.,#,#,#,#,#,.,#,#,#,.,#,#,#,#,#,.,#,.,#,#,#,.,#,.,#,#,#,.,#,#,#,#,#,#,#,.,#,.,#,.,#,.,#
#,.,#,.,.,.,.,.,.,.,.,.,#,.,.,.,#,.,.,.,#,.,.,.,.,.,.,.,#,.,#,.,.,.,#,.,#,.,.,.,.,.,#,.,#,.,#,.,#,.,.,.,#,.,.,.,#,.,.,.,.,.,#,.,#,.,.,.,#,.,.,.,#,.,.,.,.,.,.,.,#,.,.,.,#,.,#,.,#
#,.,#,.,#,#,#,#,#,.,#,#,#,#,#,.,#,#,#,.,#,#,#,#,#,#,#,#,#,.,#,#,#,.,#,.,#,.,#,#,#,#,#,.,#,.,#,.,#,.,#,#,#,#,#,.,#,#,#,.,#,#,#,.,#,.,#,.,#,#,#,.,#,#,#,#,#,#,#,.,#,#,#,#,#,.,#,.,#
#,.,.,.,#,.,.,.,#,.,.,.,.,.,#,.,#,.,.,.,#,.,#,.,.,.,.,.,#,.,.,.,#,.,#,.,#,.,.,.,.,.,.,.,#,.,.,.,#,.,.,.,.,.,#,.,.,.,#,.,.,.,#,.,#,.,#,.,.,.,#,.,.,.,.,.,.,.,#,.,#,.,.,.,.,.,#,.,#
#,.,#,#,#,.,#,.,#,#,#,#,#,.,#,.,#,.,#,#,#,.,#,.,#,#,#,.,#,#,#,.,#,.,#,.,#,.,#,#,#,#,#,#,#,#,#,.,#,#,#,#,#,.,#,#,#,.,#,.,#,#,#,.,#,.,#,#,#,.,#,#,#,#,#,#,#,.,#,.,#,.,#,#,#,#,#,.,#
#,.,.,.,#,.,#,.,.,.,.,.,#,.,#,.,#,.,#,.,.,.,#,.,#,.,.,.,#,.,.,.,#,.,.,.,#,.,#,.,.,.,.,.,.,.,.,.,#,.,.,.,.,.,#,.,#,.,#,.,#,.,.,.,#,.,#,.,.,.,.,.,.,.,#,.,#,.,#,.,#,.,.,.,#,.,#,.,#
#,#,#,.,#,#,#,.,#,#,#,.,#,.,#,.,#,.,#,.,#,.,#,.,#,#,#,.,#,.,#,#,#,#,#,#,#,.,#,#,#,#,#,#,#,#,#,#,#,.,#,#,#,#,#,.,#,.,#,#,#,.,#,#,#,.,#,.,#,#,#,#,#,.,#,.,#,.,#,.,#,#,#,.,#,.,#,.,#
#,.,#,.,.,.,.,.,#,.,#,.,#,.,.,.,#,.,.,.,#,.,#,.,.,.,#,.,.,.,#,.,.,.,#,.,.,.,#,.,.,.,#,.,.,.,#,.,.,.,#,.,.,.,.,.,#,.,.,.,#,.,.,.,#,.,#,.,.,.,#,.,.,.,#,.,#,.,#,.,.,.,#,.,#,.,.,.,#
#,.,#,#,#,#,#,#,#,.,#,.,#,#,#,#,#,#,#,.,#,#,#,#,#,.,#,#,#,#,#,.,#,.,#,.,#,#,#,.,#,.,#,.,#,.,#,.,#,#,#,#,#,.,#,.,#,#,#,.,#,#,#,.,#,.,#,#,#,.,#,.,#,#,#,.,#,.,#,#,#,#,#,.,#,.,#,#,#
#,.,.,.,.,.,#,.,.,.,.,.,#,.,.,.,.,.,.,.,#,.,.,.,.,.,#,.,.,.,.,.,#,.,#,.,.,.,.,.,#,.,.,.,#,.,.,.,#,.,.,.,.,.,#,.,.,.,#,.,#,.,.,.,#,.,#,.,#,.,#,.,.,.,.,.,#,.,#,.,.,.,#,.,#,.,.,.,#
#,.,#,.,#,.,#,.,#,#,#,#,#,#,#,#,#,#,#,#,#,.,#,#,#,#,#,.,#,.,#,#,#,#,#,#,#,#,#,#,#,#,#,#,#,#,#,#,#,.,#,#,#,#,#,#,#,.,#,.,#,.,#,#,#,.,#,.,#,.,#,#,#,#,#,#,#,.,#,.,#,.,#,.,#,#,#,.,#
#,.,#,.,#,.,#,.,.,.,.,.,.,.,#,.,.,.,.,.,#,.,.,.,#,.,#,.,#,.,.,.,.,.,#,.,.,.,.,.,.,.,#,.,#,.,.,.,.,.,#,.,.,.,#,.,.,.,#,.,.,.,#,.,#,.,#,.,#,.,.,.,.,.,.,.,#,.,.,.,#,.,.,.,#,.,#,.,#
#,.,#,.,#,#,#,#,#,#,#,#,#,.,#,.,#,#,#,.,#,.,#,.,#,.,#,.,#,#,#,#,#,.,#,.,#,.,#,#,#,.,#,.,#,.,#,.,#,#,#,.,#,#,#,.,#,#,#,#,#,#,#,.,#,.,#,.,#,#,#,#,#,#,#,.,#,#,#,#,#,#,#,#,#,.,#,.,#
#,.,#,.,.,.,.,.,#,.,.,.,.,.,#,.,#,.,.,.,#,.,#,.,#,.,#,.,#,.,#,.,.,.,#,.,#,.,#,.,.,.,.,.,#,.,#,.,#,.,#,.,.,.,.,.,#,.,.,.,.,.,.,.,#,.,#,.,.,.,.,.,.,.,#,.,.,.,.,.,.,.,#,.,.,.,.,.,#
#,.,#,#,#,#,#,.,#,.,#,#,#,#,#,.,#,.,#,#,#,#,#,.,#,.,#,.,#,.,#,.,#,.,#,.,#,.,#,#,#,#,#,#,#,.,#,.,#,.,#,.,#,#,#,#,#,.,#,#,#,#,#,.,#,.,#,#,#,#,#,#,#,.,#,#,#,#,#,#,#,.,#,.,#,#,#,#,#
#,.,#,.,.,.,#,.,.,.,#,.,.,.,.,.,#,.,.,.,.,.,#,.,#,.,#,.,.,.,#,.,#,.,#,.,#,.,#,.,.,.,.,.,#,.,#,.,#,.,.,.,.,.,#,.,.,.,#,.,.,.,#,.,#,.,.,.,.,.,#,.,.,.,#,.,.,.,.,.,#,.,#,.,.,.,#,.,#
#,.,#,#,#,.,#,#,#,#,#,#,#,#,#,.,#,#,#,#,#,.,#,.,#,.,#,#,#,.,#,.,#,#,#,.,#,.,#,.,#,#,#,.,#,.,#,.,#,#,#,#,#,#,#,.,#,#,#,.,#,.,#,.,#,#,#,#,#,.,#,.,#,.,#,#,#,.,#,.,#,.,#,#,#,.,#,.,#
#,.,.,.,.,.,.,.,.,.,.,.,.,.,.,.,#,.,.,.,.,.,.,.,#,.,.,.,.,.,#,.,.,.,.,.,#,.,.,.,.,.,#,.,.,.,#,.,.,.,.,.,.,.,.,.,.,.,.,.,#,.,#,.,.,.,.,.,.,.,.,.,#,.,.,.,.,.,#,.,#,.,.,.,.,.,.,G,#
#,#,#,#,#,#,#,#,#,#,#,#,#,#,#,#,#,#,#,#,#,#,#,#,#,#,#,#,#,#,#,#,#,#,#,#,#,#,#,#,#,#,#,#,#,#,#,#,#,#,#,#,#,#,#,#,#,#,#,#,#,#,#,#,#,#,#,#,#,#,#,#,#,#,#,#,#,#,#,#,#,#,#,#,#,#,#,#,#
