#,#,#,#,#,#,#,#,#,#,#,#,#,#,#,#,#
#,S,#,.,.,.,.,.,.,.,.,.,#,.,.,.,#
#,.,#,#,#,.,#,#,#,.,#,.,#,.,#,#,#
#,.,.,.,#,.,.,.,#,.,#,.,#,.,.,.,#
#,#,#,.,.,#,#,#,#,.,#,.,#,#,#,.,#
#,.,#,.,.,.,.,.,.,.,.,.,#,.,.,.,#
#,.,#,#,#,#,#,#,#,#,#,.,.,.,#,.,#
#,.,.,.,#,.,.,.,.,.,.,.,#,.,#,.,#
#,.,#,#,#,.,#,#,#,#,#,#,#,.,#,.,#
#,.,.,.,#,.,#,.,.,.,.,.,#,.,#,.,#
#,.,#,.,#,.,#,#,#,.,#,.,#,.,#,.,#
#,.,#,.,#,.,.,.,.,.,#,.,.,.,.,.,#
#,.,#,.,#,#,#,#,#,.,#,.,.,.,#,.,#
#,.,#,.,.,.,.,.,.,.,.,.,#,.,#,.,#
#,.,#,.,#,#,#,.,#,#,#,#,#,.,#,.,#
#,.,#,.,.,.,.,.,.,.,.,.,.,.,#,G,#
#,#,#,#,#,#,#,#,#,#,#,#,#,#,#,#,#
