#,#,#,#,#,#,#,#,#,#,#,#,#,#,#,#,#,#,#,#,#,#,#,#,#,#,#,#,#,#,#,#,#,#,#,#,#,#,#,#,#,#,#,#,#,#,#,#,#,#,#,#,#,#,#,#,#,#,#,#,#,#,#,#,#,#,#
#,S,#,.,.,.,.,.,.,.,.,.,.,.,.,.,.,.,#,.,.,.,.,.,#,.,.,.,.,.,.,.,#,.,.,.,#,.,.,.,#,.,.,.,.,.,#,.,.,.,#,.,.,.,.,.,.,.,.,.,.,.,#,.,.,.,#
#,.,#,#,#,.,#,#,#,.,#,#,#,#,#,#,#,.,#,.,#,#,#,#,#,.,#,#,#,.,#,.,#,.,#,.,#,.,#,.,#,.,#,.,#,#,#,.,#,.,#,.,#,.,#,#,#,#,#,#,#,#,#,.,#,.,#
#,.,.,.,#,.,#,.,.,.,#,.,.,.,#,.,.,.,#,.,#,.,.,.,.,.,#,.,#,.,#,.,.,.,#,.,#,.,#,.,.,.,#,.,.,.,.,.,#,.,.,.,#,.,#,.,.,.,.,.,.,.,.,.,#,.,#
#,#,#,.,#,.,#,.,#,#,#,.,#,#,#,.,#,#,#,.,#,.,#,#,#,#,#,.,#,.,#,#,#,#,#,#,#,.,#,#,#,#,#,#,#,#,#,#,#,#,#,#,#,.,#,.,#,#,#,#,#,#,#,#,#,.,#
#,.,.,.,#,.,#,.,.,.,#,.,.,.,.,.,#,.,.,.,#,.,#,.,.,.,.,.,#,.,.,.,#,.,.,.,#,.,#,.,.,.,#,.,.,.,#,.,.,.,.,.,.,.,#,.,#,.,.,.,.,.,.,.,#,.,#
#,.,#,#,#,.,#,#,#,.,#,.,#,#,#,#,#,.,#,.,#,.,#,.,#,#,#,.,#,#,#,.,#,.,#,.,#,.,#,.,#,.,#,#,#,.,#,.,#,#,#,#,#,#,#,.,#,#,#,.,#,#,#,.,#,.,#
#,.,#,.,.,.,#,.,.,.,#,.,#,.,#,.,.,.,#,.,#,.,#,.,#,.,#,.,#,.,#,.,#,.,#,.,#,.,#,.,#,.,.,.,.,.,#,.,.,.,.,.,.,.,.,.,.,.,#,.,#,.,.,.,#,.,#
#,.,#,#,#,#,#,.,#,#,#,.,#,.,#,.,#,#,#,.,#,.,#,.,#,.,#,.,#,.,#,.,#,.,#,.,#,.,#,.,#,#,#,#,#,.,#,#,#,#,#,#,#,#,#,#,#,.,#,.,#,.,#,#,#,.,#
#,.,.,.,.,.,.,.,#,.,#,.,#,.,.,.,.,.,#,.,.,.,.,.,#,.,.,.,.,.,#,.,.,.,#,.,.,.,#,.,#,.,.,.,#,.,.,.,.,.,#,.,.,.,.,.,#,.,.,.,#,.,#,.,.,.,#
#,#,#,#,#,#,#,#,#,.,#,.,#,#,#,#,#,.,#,#,#,#,#,#,#,#,#,#,#,.,#,#,#,#,#,#,#,#,#,.,#,.,#,.,#,#,#,#,#,.,#,.,#,#,#,.,#,#,#,#,#,.,#,.,#,.,#
#,.,.,.,.,.,.,.,#,.,.,.,#,.,.,.,#,.,.,.,#,.,.,.,.,.,.,.,#,.,.,.,#,.,.,.,.,.,.,.,.,.,#,.,.,.,#,.,.,.,#,.,.,.,#,.,.,.,.,.,#,.,#,.,#,.,#
#,.,#,#,#,#,#,.,#,.,#,#,#,.,#,.,#,#,#,.,#,.,#,#,#,#,#,.,#,#,#,.,#,#,#,.,#,#,#,#,#,#,#,#,#,.,#,#,#,#,#,.,#,.,#,#,#,#,#,.,#,#,#,.,#,.,#
#,.,.,.,#,.,.,.,#,.,#,.,.,.,#,.,.,.,#,.,#,.,#,.,.,.,#,.,#,.,#,.,.,.,#,.,#,.,.,.,.,.,.,.,.,.,#,.,.,.,#,.,#,.,#,.,#,.,.,.,#,.,.,.,#,.,#
#,.,#,.,#,.,#,#,#,.,#,.,#,#,#,#,#,.,#,#,#,.,#,.,#,#,#,.,#,.,#,#,#,.,#,#,#,.,#,#,#,#,#,#,#,#,#,.,#,.,#,#,#,.,#,.,#,.,#,#,#,.,#,#,#,.,#
#,.,#,.,#,.,#,.,.,.,#,.,.,.,#,.,.,.,.,.,.,.,#,.,#,.,.,.,#,.,.,.,#,.,#,.,.,.,#,.,.,.,.,.,#,.,.,.,#,.,.,.,#,.,#,.,.,.,.,.,.,.,#,.,#,.,#
#,#,#,.,#,.,#,.,#,#,#,#,#,.,#,#,#,#,#,#,#,#,#,.,#,.,#,#,#,.,#,.,#,.,#,.,#,.,#,.,#,#,#,.,#,.,#,#,#,#,#,.,#,.,#,.,#,#,#,#,#,#,#,.,#,.,#
#,.,.,.,#,.,#,.,#,.,.,.,#,.,.,.,.,.,.,.,.,.,#,.,#,.,#,.,.,.,#,.,#,.,#,.,#,.,#,.,.,.,#,.,#,.,#,.,.,.,.,.,#,.,#,.,#,.,.,.,#,.,#,.,.,.,#
#,.,#,#,#,#,#,.,#,.,#,.,#,#,#,.,#,#,#,#,#,.,#,.,#,.,#,.,#,.,#,.,#,.,#,.,#,.,#,#,#,.,#,.,#,.,#,#,#,#,#,.,#,.,#,#,#,.,#,.,#,.,#,.,#,#,#
#,.,.,.,.,.,#,.,.,.,#,.,.,.,#,.,#,.,.,.,.,.,#,.,.,.,#,.,#,.,#,.,#,.,.,.,#,.,#,.,.,.,#,.,.,.,#,.,.,.,#,.,#,.,.,.,.,.,#,.,#,.,#,.,.,.,#
#,.,#,#,#,.,#,#,#,#,#,#,#,.,#,#,#,.,#,#,#,#,#,.,#,#,#,.,#,.,#,#,#,#,#,#,#,.,#,.,#,.,#,#,#,#,#,.,#,.,#,.,#,.,#,#,#,#,#,.,#,.,#,#,#,.,#
#,.,#,.,.,.,#,.,.,.,.,.,#,.,.,.,#,.,#,.,#,.,.,.,#,.,#,.,#,.,#,.,.,.,.,.,.,.,#,.,#,.,#,.,.,.,#,.,#,.,#,.,#,.,#,.,.,.,#,.,#,.,.,.,.,.,#
#,.,#,.,#,#,#,.,#,#,#,.,#,#,#,.,#,.,#,.,#,.,#,#,#,.,#,.,#,.,#,.,#,#,#,#,#,#,#,.,#,#,#,.,#,.,#,.,#,.,#,.,#,#,#,.,#,.,#,.,#,.,#,#,#,#,#
#,.,#,.,.,.,.,.,.,.,#,.,#,.,.,.,#,.,#,.,.,.,.,.,#,.,#,.,#,.,.,.,#,.,#,.,.,.,#,.,#,.,.,.,#,.,.,.,#,.,#,.,.,.,#,.,#,.,.,.,#,.,.,.,#,.,#
#,.,#,#,#,#,#,#,#,#,#,.,#,.,#,#,#,.,#,#,#,#,#,.,#,.,#,.,#,#,#,#,#,.,#,.,#,.,#,.,#,.,#,#,#,#,#,#,#,.,#,#,#,.,#,.,#,#,#,#,#,#,#,.,#,.,#
#,.,#,.,#,.,.,.,.,.,.,.,#,.,#,.,.,.,.,.,.,.,#,.,#,.,.,.,#,.,.,.,.,.,.,.,#,.,#,.,.,.,#,.,.,.,#,.,.,.,#,.,#,.,#,.,.,.,#,.,.,.,#,.,.,.,#
#,.,#,.,#,.,#,#,#,.,#,#,#,.,#,.,#,#,#,#,#,.,#,.,#,.,#,#,#,#,#,#,#,#,#,#,#,.,#,#,#,#,#,.,#,.,#,.,#,#,#,.,#,.,#,#,#,.,#,.,#,.,#,#,#,.,#
#,.,.,.,#,.,#,.,.,.,#,.,.,.,#,.,.,.,#,.,.,.,#,.,#,.,.,.,.,.,.,.,.,.,.,.,.,.,.,.,#,.,.,.,#,.,.,.,#,.,.,.,.,.,#,.,.,.,#,.,#,.,.,.,#,.,#
#,#,#,#,#,.,#,.,#,#,#,.,#,#,#,#,#,#,#,.,#,#,#,.,#,#,#,.,#,#,#,#,#,#,#,.,#,#,#,#,#,.,#,#,#,#,#,#,#,.,#,#,#,#,#,.,#,#,#,.,#,#,#,#,#,.,#
#,.,.,.,.,.,#,.,.,.,#,.,.,.,.,.,#,.,.,.,#,.,#,.,.,.,#,.,#,.,.,.,#,.,.,.,#,.,.,.,.,.,#,.,.,.,.,.,#,.,.,.,.,.,.,.,#,.,.,.,.,.,.,.,.,.,#
#,.,#,#,#,#,#,#,#,.,#,#,#,#,#,.,#,.,#,#,#,.,#,#,#,.,#,#,#,.,#,.,#,#,#,#,#,.,#,#,#,#,#,.,#,#,#,#,#,#,#,#,#,#,#,#,#,.,#,#,#,#,#,#,#,#,#
#,.,#,.,.,.,.,.,.,.,#,.,.,.,#,.,#,.,.,.,#,.,#,.,.,.,.,.,.,.,#,.,.,.,.,.,.,.,#,.,.,.,#,.,.,.,.,.,.,.,.,.,.,.,.,.,#,.,.,.,#,.,.,.,.,.,#
#,.,#,#,#,#,#,#,#,.,#,.,#,.,#,.,#,.,#,.,#,.,#,.,#,#,#,#,#,#,#,#,#,.,#,#,#,#,#,.,#,.,#,.,#,#,#,#,#,#,#,#,#,.,#,.,#,#,#,.,#,#,#,#,#,.,#
#,.,.,.,#,.,.,.,#,.,#,.,#,.,.,.,#,.,#,.,#,.,.,.,#,.,.,.,#,.,.,.,.,.,#,.,.,.,.,.,#,.,#,.,.,.,.,.,#,.,.,.,#,.,#,.,#,.,.,.,#,.,.,.,#,.,#
#,#,#,.,#,.,#,.,#,#,#,.,#,#,#,#,#,.,#,.,#,.,#,#,#,.,#,.,#,#,#,#,#,#,#,.,#,#,#,#,#,.,#,#,#,#,#,#,#,.,#,.,#,.,#,.,#,.,#,#,#,.,#,.,#,.,#
#,.,.,.,#,.,#,.,.,.,#,.,.,.,#,.,#,.,#,.,#,.,#,.,.,.,#,.,.,.,.,.,.,.,.,.,.,.,.,.,#,.,.,.,#,.,.,.,.,.,#,.,.,.,#,.,#,.,#,.,.,.,#,.,.,.,#
#,.,#,#,#,.,#,#,#,.,#,#,#,.,#,.,#,.,#,.,#,#,#,.,#,#,#,#,#,#,#,#,#,#,#,#,#,#,#,#,#,#,#,.,#,.,#,#,#,#,#,#,#,#,#,#,#,.,#,.,#,#,#,#,#,.,#
#,.,.,.,.,.,#,.,#,.,.,.,#,.,#,.,#,.,#,.,.,.,.,.,#,.,.,.,.,.,#,.,.,.,.,.,.,.,.,.,.,.,.,.,#,.,.,.,.,.,#,.,.,.,#,.,.,.,#,.,.,.,#,.,.,.,#
#,.,#,#,#,#,#,.,#,#,#,.,#,.,#,.,#,.,#,#,#,#,#,#,#,#,#,#,#,.,#,.,#,#,#,#,#,#,#,#,#,#,#,#,#,.,#,#,#,.,#,.,#,.,#,.,#,#,#,.,#,.,#,.,#,#,#
#,.,#,.,.,.,.,.,#,.,#,.,.,.,#,.,.,.,#,.,.,.,.,.,.,.,.,.,#,.,#,.,#,.,.,.,#,.,.,.,#,.,.,.,.,.,#,.,#,.,.,.,#,.,.,.,#,.,.,.,#,.,#,.,.,.,#
#,.,#,.,#,#,#,.,#,.,#,#,#,#,#,.,#,#,#,.,#,#,#,#,#,#,#,.,#,.,#,.,#,.,#,.,#,.,#,.,#,.,#,#,#,#,#,.,#,#,#,#,#,#,#,#,#,.,#,#,#,.,#,#,#,#,#
#,.,.,.,#,.,.,.,#,.,.,.,.,.,#,.,#,.,.,.,.,.,#,.,#,.,.,.,.,.,#,.,.,.,#,.,#,.,#,.,#,.,#,.,.,.,.,.,.,.,#,.,.,.,.,.,.,.,#,.,#,.,.,.,.,.,#
#,#,#,#,#,.,#,#,#,.,#,#,#,.,#,.,#,#,#,#,#,.,#,.,#,.,#,#,#,#,#,#,#,#,#,.,#,.,#,.,#,.,#,.,#,#,#,#,#,.,#,#,#,#,#,.,#,#,#,.,#,#,#,#,#,.,#
#,.,#,.,.,.,#,.,.,.,.,.,#,.,#,.,.,.,#,.,.,.,#,.,.,.,.,.,#,.,.,.,#,.,.,.,#,.,#,.,#,.,#,.,.,.,#,.,#,.,#,.,.,.,#,.,.,.,#,.,.,.,.,.,#,.,#
#,.,#,.,#,#,#,.,#,#,#,.,#,#,#,#,#,.,#,.,#,#,#,#,#,#,#,#,#,.,#,.,#,.,#,#,#,#,#,.,#,.,#,#,#,.,#,.,#,.,#,.,#,.,#,#,#,.,#,#,#,.,#,.,#,.,#
#,.,.,.,#,.,#,.,.,.,#,.,.,.,.,.,.,.,.,.,#,.,.,.,.,.,.,.,.,.,#,.,#,.,.,.,.,.,#,.,#,.,.,.,#,.,#,.,.,.,#,.,#,.,.,.,#,.,.,.,.,.,#,.,#,.,#
#,.,#,#,#,.,#,#,#,.,#,#,#,#,#,#,#,#,#,#,#,.,#,#,#,#,#,#,#,#,#,.,#,#,#,#,#,.,#,.,#,#,#,.,#,.,#,.,#,#,#,.,#,#,#,.,#,#,#,.,#,#,#,#,#,.,#
#,.,#,.,.,.,.,.,.,.,#,.,.,.,.,.,.,.,.,.,#,.,#,.,.,.,.,.,.,.,#,.,.,.,.,.,.,.,#,.,#,.,.,.,#,.,#,.,.,.,.,.,#,.,#,.,.,.,#,.,#,.,.,.,#,.,#
#,.,#,.,#,#,#,#,#,#,#,.,#,#,#,#,#,#,#,.,#,.,#,.,#,#,#,#,#,#,#,#,#,#,#,#,#,#,#,.,#,.,#,#,#,.,#,#,#,#,#,#,#,.,#,#,#,.,#,#,#,.,#,.,#,.,#
#,.,#,.,.,.,.,.,.,.,#,.,.,.,#,.,.,.,#,.,.,.,#,.,.,.,.,.,.,.,.,.,#,.,.,.,.,.,.,.,#,.,#,.,#,.,.,.,.,.,#,.,.,.,.,.,#,.,.,.,.,.,#,.,#,.,#
#,.,#,#,#,#,#,.,#,#,#,#,#,.,#,.,#,#,#,#,#,#,#,#,#,#,#,#,#,.,#,#,#,.,#,.,#,.,#,#,#,.,#,.,#,.,#,#,#,.,#,.,#,#,#,.,#,#,#,#,#,#,#,.,#,.,#
#,.,.,.,.,.,#,.,#,.,.,.,#,.,#,.,.,.,.,.,.,.,.,.,.,.,#,.,.,.,#,.,.,.,#,.,#,.,#,.,.,.,#,.,.,.,#,.,.,.,#,.,.,.,#,.,.,.,.,.,#,.,#,.,#,.,#
#,#,#,#,#,.,#,.,#,.,#,.,#,.,#,.,#,#,#,#,#,.,#,#,#,.,#,.,#,.,#,.,#,#,#,.,#,#,#,.,#,#,#,.,#,#,#,.,#,#,#,#,#,.,#,#,#,.,#,.,#,.,#,.,#,.,#
#,.,#,.,.,.,#,.,#,.,#,.,.,.,#,.,.,.,.,.,#,.,.,.,#,.,.,.,#,.,#,.,#,.,.,.,#,.,.,.,#,.,.,.,.,.,#,.,#,.,.,.,#,.,.,.,#,.,#,.,#,.,#,.,#,.,#
#,.,#,.,#,#,#,.,#,.,#,#,#,#,#,.,#,#,#,#,#,#,#,.,#,.,#,#,#,#,#,.,#,.,#,#,#,.,#,#,#,#,#,.,#,#,#,.,#,.,#,#,#,.,#,#,#,.,#,.,#,.,#,.,#,.,#
#,.,.,.,#,.,.,.,#,.,.,.,#,.,.,.,#,.,.,.,.,.,#,.,#,.,#,.,.,.,.,.,#,.,.,.,#,.,.,.,.,.,#,.,#,.,.,.,#,.,.,.,.,.,#,.,.,.,#,.,.,.,#,.,.,.,#
#,.,#,#,#,.,#,#,#,#,#,.,#,#,#,#,#,.,#,#,#,.,#,.,#,#,#,.,#,#,#,#,#,#,#,.,#,#,#,#,#,.,#,#,#,.,#,#,#,.,#,#,#,#,#,.,#,#,#,.,#,#,#,#,#,.,#
#,.,#,.,#,.,#,.,.,.,#,.,.,.,#,.,.,.,#,.,.,.,#,.,#,.,.,.,#,.,.,.,.,.,#,.,.,.,.,.,#,.,.,.,.,.,#,.,.,.,#,.,.,.,#,.,.,.,#,.,#,.,.,.,.,.,#
#,.,#,.,#,.,#,.,#,#,#,#,#,.,#,.,#,#,#,.,#,#,#,.,#,.,#,#,#,.,#,#,#,.,#,#,#,.,#,#,#,#,#,#,#,#,#,.,#,#,#,.,#,.,#,#,#,.,#,#,#,.,#,#,#,#,#
#,.,#,.,.,.,.,.,#,.,.,.,.,.,#,.,#,.,.,.,#,.,.,.,#,.,#,.,.,.,#,.,#,.,.,.,#,.,.,.,.,.,.,.,.,.,#,.,.,.,.,.,#,.,#,.,#,.,.,.,.,.,#,.,.,.,#
#,.,#,#,#,#,#,.,#,.,#,#,#,#,#,.,#,.,#,#,#,.,#,.,#,.,#,.,#,#,#,.,#,#,#,.,#,#,#,#,#,#,#,#,#,.,#,#,#,#,#,#,#,.,#,.,#,#,#,#,#,#,#,#,#,.,#
#,.,.,.,.,.,#,.,#,.,.,.,#,.,.,.,#,.,.,.,.,.,#,.,#,.,#,.,.,.,#,.,#,.,.,.,#,.,.,.,.,.,#,.,.,.,.,.,.,.,.,.,#,.,.,.,#,.,.,.,.,.,#,.,.,.,#
#,#,#,#,#,.,#,#,#,.,#,.,#,.,#,#,#,#,#,#,#,.,#,#,#,.,#,#,#,.,#,.,#,.,#,#,#,.,#,#,#,.,#,.,#,#,#,.,#,#,#,#,#,#,#,.,#,.,#,.,#,.,#,.,#,.,#
#,.,.,.,#,.,.,.,#,.,#,.,#,.,#,.,.,.,#,.,.,.,#,.,.,.,#,.,.,.,#,.,#,.,#,.,.,.,#,.,#,.,#,.,.,.,#,.,#,.,.,.,.,.,.,.,#,.,#,.,#,.,.,.,#,.,#
#,.,#,.,#,#,#,.,#,#,#,.,#,.,#,.,#,.,#,#,#,#,#,.,#,#,#,.,#,#,#,.,#,.,#,#,#,.,#,.,#,.,#,#,#,.,#,#,#,.,#,#,#,#,#,#,#,#,#,.,#,#,#,#,#,.,#
#,.,#,.,.,.,.,.,.,.,.,.,#,.,.,.,#,.,.,.,.,.,.,.,.,.,.,.,#,.,.,.,.,.,.,.,.,.,#,.,.,.,.,.,#,.,.,.,.,.,.,.,.,.,.,.,.,.,.,.,#,.,.,.,.,G,#
#,#,#,#,#,#,#,#,#,#,#,#,#,#,#,#,#,#,#,#,#,#,#,#,#,#,#,#,#,#,#,#,#,#,#,#,#,#,#,#,#,#,#,#,#,#,#,#,#,#,#,#,#,#,#,#,#,#,#,#,#,#,#,#,#,#,#
