#,#,#,#,#,#,#,#,#,#,#,#,#,#,#,#,#,#,#,#,#,#,#,#,#,#,#,#,#,#,#,#,#,#,#,#,#,#,#,#,#,#,#,#,#,#,#,#,#,#,#,#,#,#,#,#,#,#,#,#,#,#,#,#,#,#,#
#,S,#,.,.,.,.,.,.,.,#,.,.,.,.,.,#,.,.,.,.,.,.,.,.,.,.,.,#,.,.,.,.,.,.,.,.,.,.,.,.,.,.,.,.,.,.,.,.,.,#,.,.,.,.,.,.,.,.,.,#,.,.,.,.,.,#
#,.,#,.,.,#,.,#,#,.,#,.,#,#,#,.,#,.,#,#,.,.,#,#,#,#,#,#,#,.,#,#,#,#,#,#,#,.,#,#,#,.,#,#,#,#,#,#,#,.,#,.,#,#,#,.,.,#,#,.,#,#,#,#,#,.,#
#,.,#,.,.,.,.,.,#,.,.,.,#,.,#,.,#,.,.,.,#,.,.,.,.,.,.,.,#,.,.,.,.,.,.,.,.,.,.,.,#,.,#,.,.,.,.,.,#,.,#,.,.,.,.,.,#,.,.,.,#,.,.,.,.,.,#
#,.,#,#,#,#,#,.,#,#,.,#,.,.,#,.,#,.,#,#,#,.,#,.,#,#,#,.,#,.,#,#,#,.,#,.,#,#,#,.,#,.,#,.,#,#,#,.,#,#,#,.,#,.,#,.,#,#,.,.,#,.,#,.,#,.,#
#,.,.,.,.,.,.,.,#,.,.,.,.,.,#,.,#,.,#,.,.,.,#,.,.,.,#,.,.,.,.,.,.,.,.,.,.,.,.,.,#,.,.,.,#,.,#,.,.,.,#,.,#,.,.,.,.,.,#,.,.,.,#,.,.,.,#
#,#,#,#,#,#,#,#,#,.,#,#,#,.,#,.,#,#,#,.,#,#,#,#,#,.,#,.,#,#,#,#,#,.,#,.,#,#,#,.,#,#,#,.,#,.,#,#,#,.,#,.,#,#,#,.,#,.,#,#,#,#,#,#,#,#,#
#,.,.,.,.,.,.,.,.,.,#,.,.,.,#,.,.,.,#,.,.,.,.,.,.,.,#,.,.,.,#,.,.,.,#,.,#,.,.,.,.,.,#,.,.,.,#,.,.,.,#,.,.,.,#,.,#,.,.,.,.,.,.,.,.,.,#
#,.,#,.,#,.,#,.,#,#,#,.,#,.,#,#,#,.,#,.,#,.,#,#,#,#,#,.,#,#,#,.,#,#,#,.,#,#,.,#,#,.,#,.,#,#,#,.,#,.,#,#,#,.,#,.,#,#,#,#,#,#,#,#,#,.,#
#,.,#,.,#,.,#,.,.,.,#,.,.,.,#,.,#,.,.,.,#,.,.,.,.,.,#,.,.,.,.,.,#,.,#,.,.,.,.,.,#,.,.,.,.,.,#,.,#,.,.,.,#,.,#,.,.,.,.,.,#,.,.,.,.,.,#
#,#,#,.,#,.,#,#,#,.,#,#,#,.,#,.,#,#,#,.,#,#,#,#,#,#,#,.,#,#,#,#,#,.,#,#,#,#,#,.,#,#,#,#,#,.,#,.,#,#,#,.,#,.,#,#,#,.,#,.,#,.,#,#,#,.,#
#,.,.,.,#,.,.,.,.,.,#,.,#,.,#,.,.,.,#,.,.,.,.,.,.,.,#,.,#,.,.,.,#,.,.,.,#,.,.,.,#,.,.,.,.,.,.,.,#,.,#,.,#,.,#,.,.,.,#,.,#,.,#,.,.,.,#
#,.,#,#,#,#,#,#,#,#,#,.,#,.,#,.,#,#,#,#,#,#,#,#,#,.,#,.,#,.,#,.,.,.,#,#,#,.,#,#,#,.,#,.,#,#,#,.,#,.,#,.,.,.,#,.,#,#,#,#,.,.,#,.,#,#,#
#,.,.,.,.,.,.,.,.,.,#,.,#,.,#,.,#,.,.,.,.,.,.,.,#,.,#,.,.,.,#,.,#,.,.,.,#,.,.,.,.,.,#,.,.,.,.,.,#,.,#,.,#,.,#,.,#,.,.,.,.,.,#,.,#,.,#
#,#,#,#,#,.,#,.,#,.,.,.,#,.,#,.,#,.,#,.,#,#,#,#,#,.,#,#,#,.,#,.,#,#,#,.,#,#,#,#,#,.,#,.,#,.,#,#,#,.,#,.,#,.,.,.,.,.,.,#,#,#,#,.,#,.,#
#,.,.,.,#,.,.,.,.,.,#,.,.,.,.,.,#,.,#,.,.,.,.,.,.,.,.,.,.,.,#,.,.,.,#,.,.,.,.,.,#,.,#,.,#,.,#,.,.,.,.,.,#,.,#,.,.,.,.,.,#,.,.,.,.,.,#
#,.,#,.,#,#,#,.,#,.,#,#,#,#,#,#,#,.,#,#,#,#,#,#,#,#,.,.,#,.,#,#,#,.,#,.,#,#,#,#,#,.,#,.,#,.,#,#,#,#,#,.,#,.,#,.,#,#,#,.,#,#,#,#,#,#,#
#,.,.,.,.,.,.,.,#,.,#,.,.,.,.,.,#,.,#,.,.,.,.,.,.,.,.,.,#,.,.,.,.,.,#,.,.,.,.,.,.,.,#,.,#,.,.,.,.,.,.,.,#,.,.,.,#,.,#,.,.,.,.,.,.,.,#
#,.,#,#,#,#,.,#,#,.,#,.,#,#,#,.,#,.,#,#,#,#,.,#,#,#,#,.,#,#,#,.,#,.,#,.,#,.,#,#,#,#,#,.,#,#,#,#,#,.,#,.,#,#,#,.,#,.,#,#,#,#,#,#,#,.,#
#,.,.,.,#,.,.,.,.,.,#,.,.,.,#,.,#,.,.,.,.,.,.,.,.,.,#,.,#,.,.,.,#,.,#,.,.,.,#,.,.,.,.,.,.,.,.,.,#,.,#,.,.,.,.,.,.,.,#,.,.,.,#,.,.,.,#
#,.,.,.,#,#,#,#,#,#,#,.,#,#,#,.,#,#,#,#,#,#,#,#,#,.,#,.,#,.,#,.,#,.,#,.,#,.,#,#,#,#,#,.,#,#,#,.,#,#,#,#,#,#,#,#,#,.,#,.,#,.,#,.,#,.,#
#,.,#,.,.,.,.,.,.,.,.,.,#,.,.,.,#,.,.,.,.,.,.,.,.,.,.,.,.,.,#,.,#,.,.,.,#,.,.,.,.,.,#,.,.,.,#,.,.,.,.,.,.,.,#,.,.,.,.,.,#,.,#,.,.,.,#
#,.,#,#,#,#,#,#,.,#,#,#,#,.,#,.,#,.,#,#,#,#,#,#,#,#,#,.,#,#,#,.,#,.,.,#,#,#,#,#,#,.,#,.,#,#,#,#,.,#,#,#,.,.,#,.,#,#,#,#,#,.,#,.,#,.,#
#,.,#,.,.,.,#,.,.,.,.,.,.,.,#,.,#,.,.,.,.,.,.,.,#,.,.,.,#,.,#,.,.,.,#,.,.,.,.,.,.,.,#,.,.,.,.,.,.,.,#,.,.,.,#,.,#,.,.,.,#,.,.,.,#,.,#
#,.,#,.,#,.,#,.,#,#,#,#,#,#,#,.,#,.,#,.,#,.,#,.,#,.,#,#,#,.,.,.,#,.,#,.,#,#,#,.,#,.,#,#,#,.,#,.,#,#,#,.,#,.,#,#,#,.,#,.,#,.,#,.,#,.,#
#,.,.,.,#,.,#,.,#,.,#,.,.,.,.,.,#,.,.,.,#,.,.,.,#,.,#,.,.,.,#,.,.,.,#,.,.,.,#,.,#,.,#,.,.,.,.,.,.,.,#,.,#,.,.,.,#,.,#,.,#,.,#,.,#,.,#
#,.,#,.,#,.,#,.,#,.,#,.,#,#,.,#,#,.,#,#,#,.,#,.,#,.,#,#,#,.,#,.,#,#,#,.,#,.,#,.,#,.,#,.,#,.,#,.,#,.,#,.,#,.,#,.,#,.,#,.,#,.,#,.,#,#,#
#,.,#,.,.,.,.,.,#,.,.,.,#,.,.,.,.,.,.,.,#,.,#,.,#,.,.,.,#,.,.,.,.,.,.,.,#,.,#,.,.,.,#,.,.,.,.,.,#,.,#,.,.,.,#,.,.,.,#,.,#,.,#,.,.,.,#
#,.,#,.,#,#,#,#,#,.,#,#,#,#,#,.,#,#,#,.,#,.,#,.,.,#,#,.,#,#,#,.,#,.,#,.,#,.,#,#,#,#,#,.,#,#,#,#,#,.,#,#,#,#,#,#,#,#,#,.,#,.,#,#,#,.,#
#,.,#,.,#,.,.,.,#,.,.,.,.,.,#,.,#,.,.,.,#,.,#,.,.,.,.,.,#,.,.,.,.,.,#,.,#,.,.,.,#,.,.,.,.,.,#,.,.,.,#,.,.,.,#,.,.,.,#,.,#,.,.,.,#,.,#
#,.,#,.,#,.,#,#,#,#,#,#,#,.,#,.,#,.,#,.,#,.,#,.,.,#,#,#,.,.,#,#,.,.,#,.,#,#,#,.,#,.,#,#,#,#,#,.,#,.,#,.,#,.,#,.,.,.,#,.,#,#,.,#,#,.,#
#,.,#,.,#,.,.,.,.,.,.,.,#,.,#,.,#,.,#,.,#,.,#,.,.,.,.,.,.,.,#,.,.,.,#,.,.,.,#,.,#,.,.,.,#,.,.,.,#,.,#,.,#,.,.,.,#,.,.,.,.,.,.,.,#,.,#
#,#,.,.,#,.,#,#,#,#,#,.,#,.,#,#,#,.,#,.,#,.,#,#,#,.,#,.,#,#,#,#,#,.,#,#,#,.,.,.,#,#,#,#,#,.,#,.,#,#,#,.,#,.,#,.,#,.,.,#,#,#,#,.,#,.,#
#,.,.,.,#,.,#,.,#,.,.,.,#,.,.,.,.,.,#,.,#,.,.,.,.,.,.,.,.,.,.,.,#,.,.,.,#,.,#,.,.,.,.,.,#,.,.,.,.,.,.,.,#,.,.,.,#,.,.,.,.,.,#,.,.,.,#
#,.,#,.,#,.,#,.,#,.,#,#,#,#,#,#,.,#,#,.,#,#,#,#,#,#,.,#,#,#,#,.,#,#,#,.,#,.,#,.,.,#,#,.,.,#,#,#,#,#,#,#,#,#,#,.,#,#,#,.,#,.,#,#,#,.,#
#,.,.,.,#,.,.,.,#,.,.,.,.,.,.,.,.,.,#,.,.,.,#,.,.,.,.,.,.,.,#,.,#,.,.,.,#,.,.,.,.,.,#,.,.,.,.,.,.,.,.,.,.,.,#,.,.,.,#,.,.,.,#,.,.,.,#
#,.,#,.,#,#,#,#,#,#,#,.,#,#,#,.,.,#,#,#,#,.,#,.,#,.,#,#,#,#,#,.,.,.,#,#,#,#,#,.,#,#,#,#,#,#,#,#,#,#,#,#,#,.,#,#,#,.,.,.,#,#,#,.,#,#,#
#,.,#,.,.,.,.,.,.,.,#,.,#,.,.,.,#,.,.,.,.,.,#,.,#,.,.,.,.,.,.,.,#,.,.,.,.,.,#,.,.,.,.,.,.,.,.,.,.,.,#,.,.,.,#,.,.,.,#,.,.,.,#,.,#,.,#
#,.,#,#,#,#,#,#,#,.,.,.,#,#,#,#,#,.,#,#,#,#,#,.,#,#,#,#,#,#,#,#,#,#,#,#,#,.,#,#,#,#,#,#,#,.,#,#,#,.,#,.,#,#,#,#,#,#,#,#,#,.,#,.,#,.,#
#,.,#,.,.,.,.,.,#,.,#,.,.,.,#,.,.,.,#,.,.,.,.,.,#,.,.,.,.,.,#,.,.,.,.,.,.,.,.,.,#,.,.,.,.,.,#,.,#,.,.,.,.,.,.,.,.,.,.,.,#,.,.,.,.,.,#
#,.,#,#,#,.,#,.,#,.,#,#,#,.,#,.,.,#,#,.,#,#,#,#,.,.,#,.,#,.,#,#,#,.,#,#,#,#,#,.,#,.,#,#,#,#,#,.,#,.,#,.,#,#,#,#,#,#,#,.,.,#,#,#,#,.,#
#,.,.,.,.,.,#,.,#,.,.,.,#,.,#,.,#,.,.,.,.,.,#,.,.,.,#,.,#,.,.,.,#,.,.,.,.,.,#,.,#,.,#,.,.,.,.,.,.,.,.,.,#,.,.,.,#,.,.,.,.,.,#,.,.,.,#
#,#,#,#,#,#,#,.,#,#,.,.,#,.,#,.,.,.,#,#,#,.,.,.,#,#,#,.,#,#,#,.,.,.,#,#,#,.,#,.,#,.,#,#,#,#,#,.,#,#,#,.,#,.,#,.,#,.,#,#,#,.,#,.,#,#,#
#,.,.,.,#,.,#,.,.,.,#,.,#,.,#,.,#,.,#,.,#,.,.,.,#,.,.,.,#,.,.,.,#,.,.,.,#,.,.,.,.,.,.,.,.,.,.,.,.,.,#,.,.,.,#,.,.,.,#,.,.,.,#,.,.,.,#
#,.,#,.,#,.,.,.,#,.,#,.,#,.,#,.,#,.,#,.,#,.,#,#,#,.,#,#,#,.,#,#,#,.,#,#,#,#,#,.,#,#,#,.,#,#,#,#,#,.,#,#,#,#,#,#,#,.,#,.,#,.,#,#,.,.,#
#,.,#,.,.,.,#,.,#,.,.,.,#,.,.,.,#,.,#,.,#,.,#,.,#,.,#,.,.,.,.,.,.,.,.,.,.,.,#,.,.,.,.,.,.,.,#,.,.,.,#,.,.,.,.,.,#,.,#,.,#,.,.,.,#,.,#
#,.,#,.,#,#,#,.,#,.,#,#,#,#,#,#,.,.,#,.,.,.,#,.,#,.,#,.,#,.,#,#,#,#,.,#,#,.,#,#,#,.,#,#,#,.,#,.,#,.,#,.,#,.,#,#,#,.,.,.,#,#,#,.,#,.,#
#,.,#,.,.,.,.,.,.,.,.,.,.,.,.,.,.,.,#,.,.,.,.,.,#,.,#,.,.,.,.,.,#,.,.,.,#,.,.,.,#,.,.,.,#,.,.,.,#,.,.,.,#,.,.,.,#,.,#,.,.,.,#,.,.,.,#
#,.,#,.,#,#,#,#,#,#,#,#,#,#,#,#,#,.,#,#,#,#,#,#,#,.,.,.,#,#,#,.,#,#,#,.,#,#,#,.,#,#,#,.,#,#,.,#,#,#,#,#,#,#,#,.,#,.,#,#,#,.,#,#,#,.,#
#,.,#,.,#,.,.,.,.,.,.,.,.,.,.,.,.,.,.,.,.,.,.,.,#,.,#,.,.,.,#,.,.,.,.,.,#,.,#,.,.,.,#,.,#,.,.,.,.,.,.,.,.,.,#,.,.,.,.,.,#,.,.,.,#,.,#
#,.,.,.,#,#,#,.,#,.,#,#,#,#,#,#,#,#,#,.,.,#,#,.,#,.,#,.,#,.,#,#,#,#,#,.,#,.,#,.,#,.,#,.,#,.,#,#,#,#,#,.,#,.,#,#,#,#,#,#,#,#,#,.,#,.,#
#,.,.,.,#,.,.,.,#,.,#,.,.,.,.,.,.,.,.,.,.,.,#,.,.,.,#,.,#,.,.,.,#,.,.,.,#,.,#,.,#,.,#,.,#,.,#,.,.,.,#,.,#,.,#,.,.,.,.,.,.,.,#,.,#,.,#
#,.,#,#,#,.,#,#,#,#,.,.,#,.,.,.,#,#,#,.,.,.,#,#,#,#,#,.,.,.,#,.,#,.,#,#,#,.,.,.,#,.,#,.,#,.,#,.,#,.,#,.,.,.,#,.,#,#,#,#,#,.,#,.,#,.,#
#,.,#,.,#,.,.,.,.,.,.,.,.,.,#,.,.,.,#,.,#,.,.,.,#,.,.,.,.,.,#,.,#,.,.,.,#,.,#,.,#,.,.,.,#,.,#,.,.,.,#,.,.,.,#,.,#,.,.,.,.,.,.,.,#,.,#
#,.,#,.,#,.,#,#,#,#,#,#,#,#,#,#,#,.,.,#,#,#,#,.,#,.,#,#,#,#,#,.,#,#,#,.,#,.,#,.,#,#,.,.,.,.,#,.,#,#,#,#,#,.,#,.,#,.,#,#,#,#,#,#,#,.,#
#,.,#,.,.,.,.,.,.,.,.,.,.,.,.,.,#,.,.,.,.,.,#,.,.,.,#,.,#,.,.,.,#,.,.,.,#,.,#,.,.,.,#,.,.,.,.,.,#,.,.,.,#,.,#,.,#,.,.,.,.,.,.,.,.,.,#
#,.,#,#,.,#,#,#,#,#,#,.,#,.,#,.,#,#,#,.,.,.,#,.,#,#,.,.,#,.,#,.,#,#,#,.,#,.,#,#,#,.,#,.,.,#,#,#,.,.,#,.,#,.,#,.,#,#,.,#,#,.,.,.,#,#,#
#,.,#,.,.,.,.,.,.,.,#,.,#,.,.,.,#,.,.,.,.,.,#,.,#,.,.,.,#,.,.,.,.,.,#,.,.,.,.,.,#,.,#,.,.,.,.,.,.,.,#,.,#,.,#,.,#,.,.,.,.,.,#,.,.,.,#
#,.,#,.,#,#,#,#,#,.,#,.,#,.,#,#,.,.,#,#,#,#,#,.,#,#,#,.,#,#,.,#,#,.,#,#,#,#,#,.,#,.,#,#,.,#,#,#,#,#,#,.,#,.,#,.,#,.,#,#,#,.,#,.,#,.,#
#,.,#,.,.,.,#,.,.,.,.,.,#,.,#,.,.,.,#,.,.,.,#,.,.,.,#,.,.,.,.,.,#,.,.,.,.,.,#,.,#,.,.,.,.,.,.,.,.,.,.,.,.,.,#,.,#,.,#,.,.,.,#,.,.,.,#
#,.,#,.,#,.,#,#,#,.,#,#,#,.,#,.,#,.,#,.,#,#,#,#,#,.,#,#,#,.,#,.,#,#,#,#,#,.,#,.,#,#,#,#,.,#,#,.,#,.,#,#,#,.,#,.,#,.,.,.,#,#,#,.,#,.,#
#,.,#,.,#,.,.,.,.,.,#,.,#,.,.,.,.,.,#,.,#,.,.,.,#,.,.,.,#,.,#,.,.,.,.,.,#,.,#,.,#,.,.,.,.,.,.,.,#,.,.,.,.,.,#,.,.,.,#,.,#,.,.,.,#,.,#
#,.,#,#,#,.,#,#,#,.,#,.,.,.,#,.,#,#,#,.,#,.,#,.,#,#,#,.,#,.,#,#,#,.,#,.,#,.,#,#,#,.,#,.,#,#,#,.,#,#,#,#,.,.,#,#,#,#,#,.,#,.,#,#,#,.,#
#,.,.,.,#,.,.,.,#,.,#,.,.,.,#,.,#,.,.,.,.,.,#,.,.,.,#,.,.,.,.,.,.,.,#,.,#,.,#,.,.,.,#,.,.,.,#,.,#,.,.,.,.,.,.,.,.,.,.,.,#,.,#,.,.,.,#
#,#,#,.,#,#,#,#,#,.,#,.,#,#,#,.,#,.,#,.,#,.,#,#,#,.,#,#,#,#,#,#,#,.,#,.,#,.,.,.,#,#,#,#,#,.,#,.,#,#,#,#,#,#,#,.,.,#,#,#,#,.,#,.,#,.,#
#,.,.,.,.,.,.,.,.,.,#,.,.,.,.,.,#,.,#,.,.,.,.,.,#,.,.,.,.,.,.,.,.,.,.,.,#,.,.,.,.,.,.,.,#,.,.,.,.,.,.,.,.,.,.,.,#,.,.,.,.,.,.,.,#,G,#
#,#,#,#,#,#,#,#,#,#,#,#,#,#,#,#,#,#,#,#,#,#,#,#,#,#,#,#,#,#,#,#,#,#,#,#,#,#,#,#,#,#,#,#,#,#,#,#,#,#,#,#,#,#,#,#,#,#,#,#,#,#,#,#,#,#,#
