#,#,#,#,#,#,#,#,#
#,S,#,.,.,.,#,.,#
#,.,#,.,#,.,#,.,#
#,.,.,.,.,.,.,.,#
#,#,#,#,#,#,#,.,#
#,.,.,.,.,.,#,.,#
#,.,#,.,#,#,#,.,#
#,.,#,.,.,.,.,G,#
#,#,#,#,#,#,#,#,#
