#,#,#,#,#,#,#,#,#,#,#
#,S,.,.,.,.,#,.,.,.,#
#,#,#,#,#,.,#,#,#,.,#
#,.,.,.,#,.,#,.,.,.,#
#,#,#,.,#,.,#,.,#,.,#
#,.,.,.,#,.,.,.,#,.,#
#,.,#,.,#,#,#,#,#,.,#
#,.,#,.,#,.,.,.,#,.,#
#,.,#,#,#,.,#,.,#,.,#
#,.,.,.,.,.,#,.,.,G,#
#,#,#,#,#,#,#,#,#,#,#
