#,#,#,#,#,#,#,#,#,#,#,#,#,#,#,#,#,#,#,#,#,#,#,#,#,#,#,#,#,#,#
#,S,.,.,.,.,.,.,.,.,#,.,.,.,.,.,.,.,.,.,.,.,.,.,.,.,.,.,#,.,#
#,#,#,#,.,#,#,#,#,.,#,#,#,#,#,.,#,#,#,#,#,#,#,#,#,#,#,.,#,.,#
#,.,.,.,.,.,.,.,#,.,#,.,.,.,#,.,.,.,.,.,.,.,.,.,#,.,.,.,#,.,#
#,#,#,#,#,.,#,.,#,.,#,.,#,.,.,.,.,.,#,.,#,#,#,.,#,.,#,#,#,.,#
#,.,.,.,.,.,#,.,#,.,.,.,#,.,#,.,#,.,.,.,.,.,#,.,#,.,.,.,.,.,#
#,.,#,#,#,#,#,.,#,#,#,#,#,.,#,.,#,.,.,#,#,.,#,.,#,#,#,#,#,.,#
#,.,.,.,#,.,.,.,#,.,.,.,#,.,#,.,.,.,.,.,.,.,#,.,.,.,#,.,.,.,#
#,#,.,.,.,.,#,#,#,#,#,.,#,.,#,#,#,#,#,#,#,.,.,#,#,.,#,#,#,.,#
#,.,.,.,#,.,.,.,.,.,.,.,#,.,.,.,#,.,.,.,.,.,.,.,#,.,.,.,#,.,#
#,.,#,#,#,#,#,#,#,#,#,#,#,#,#,.,#,#,#,#,#,#,#,#,#,#,#,.,#,.,#
#,.,#,.,.,.,#,.,.,.,#,.,.,.,#,.,.,.,.,.,.,.,.,.,.,.,.,.,#,.,#
#,.,#,.,#,.,#,.,#,.,#,.,#,.,#,.,#,.,#,#,#,#,#,#,#,#,#,#,#,.,#
#,.,.,.,.,.,.,.,.,.,.,.,.,.,.,.,#,.,#,.,.,.,.,.,.,.,#,.,.,.,#
#,.,#,#,#,#,#,.,#,#,#,#,#,#,#,#,#,.,#,.,#,#,#,#,#,.,.,.,#,#,#
#,.,#,.,.,.,.,.,#,.,.,.,.,.,.,.,#,.,.,.,#,.,.,.,.,.,#,.,#,.,#
#,.,#,#,.,#,#,.,#,.,#,.,#,.,#,.,#,#,#,#,#,.,#,#,#,#,.,.,#,.,#
#,.,#,.,.,.,#,.,#,.,#,.,#,.,.,.,.,.,.,.,.,.,.,.,#,.,.,.,#,.,#
#,.,#,.,#,.,#,.,.,.,#,.,#,.,#,#,#,#,#,#,#,.,#,.,#,.,#,#,.,.,#
#,.,#,.,#,.,.,.,#,.,.,.,#,.,#,.,.,.,.,.,.,.,#,.,.,.,#,.,.,.,#
#,.,#,.,#,#,#,#,#,.,#,.,#,.,#,.,#,#,#,.,#,.,#,.,#,#,#,#,#,.,#
#,.,#,.,.,.,#,.,.,.,#,.,.,.,#,.,#,.,.,.,#,.,#,.,.,.,.,.,.,.,#
#,.,#,.,#,.,.,.,#,#,#,.,#,#,#,.,#,.,#,#,#,#,#,#,#,#,.,#,#,.,#
#,.,#,.,#,.,.,.,.,.,#,.,#,.,#,.,#,.,.,.,#,.,.,.,#,.,.,.,.,.,#
#,.,#,#,#,#,#,.,#,#,.,.,#,.,#,.,#,#,#,.,#,.,#,.,#,.,.,#,#,#,#
#,.,#,.,.,.,.,.,#,.,.,.,#,.,.,.,#,.,#,.,.,.,#,.,.,.,#,.,.,.,#
#,.,#,.,#,#,.,.,#,.,#,#,#,.,#,#,#,.,#,#,#,#,#,#,#,#,#,#,#,.,#
#,.,#,.,#,.,#,.,#,.,#,.,.,.,#,.,.,.,.,.,.,.,.,.,.,.,.,.,#,.,#
#,.,#,.,#,.,#,.,#,.,#,.,#,.,#,.,.,#,#,#,#,.,#,#,#,#,#,.,#,.,#
#,.,.,.,#,.,.,.,.,.,#,.,.,.,.,.,#,.,.,.,.,.,.,.,.,.,.,.,.,G,#
#,#,#,#,#,#,#,#,#,#,#,#,#,#,#,#,#,#,#,#,#,#,#,#,#,#,#,#,#,#,#
