#,#,#,#,#,#,#,#,#
#,S,#,.,.,.,.,.,#
#,.,#,#,#,.,#,#,#
#,.,.,.,#,.,.,.,#
#,#,#,.,#,.,#,.,#
#,.,#,.,#,.,#,.,#
#,.,#,.,#,#,#,.,#
#,.,.,.,.,.,.,G,#
#,#,#,#,#,#,#,#,#