#,#,#,#,#,#,#,#,#,#,#,#,#,#,#,#,#,#,#,#,#,#,#,#,#,#,#,#,#,#,#,#,#,#,#,#,#,#,#,#,#,#,#,#,#,#,#,#,#,#,#,#,#,#,#,#,#,#,#
#,S,#,.,.,.,.,.,.,.,#,.,.,.,.,.,#,.,.,.,.,.,.,.,.,.,.,.,#,.,.,.,.,.,#,.,#,.,.,.,.,.,#,.,.,.,.,.,.,.,.,.,.,.,#,.,.,.,#
#,.,#,.,#,#,#,.,#,.,#,.,#,.,#,.,#,.,#,#,#,#,.,#,#,#,#,.,#,.,#,#,.,.,#,.,#,.,#,#,.,.,#,.,#,#,#,#,#,.,#,.,#,.,#,.,#,.,#
#,.,#,.,.,.,#,.,#,.,.,.,.,.,#,.,#,.,.,.,#,.,.,.,.,.,.,.,.,.,#,.,.,.,#,.,.,.,#,.,#,.,.,.,.,.,#,.,.,.,#,.,.,.,#,.,#,.,#
#,.,#,#,#,.,#,.,#,#,#,#,#,#,#,.,#,.,#,.,#,.,#,#,#,#,#,#,.,#,#,.,#,.,#,#,#,.,#,.,#,#,#,.,#,#,#,.,#,#,#,#,#,.,#,#,#,.,#
#,.,.,.,.,.,.,.,#,.,#,.,.,.,#,.,#,.,#,.,#,.,.,.,#,.,.,.,.,.,.,.,#,.,.,.,#,.,.,.,#,.,.,.,#,.,.,.,#,.,.,.,.,.,.,.,.,.,#
#,#,#,#,#,#,#,#,#,.,#,.,#,.,#,.,#,.,.,.,#,#,#,#,.,.,#,#,#,#,#,.,#,#,#,.,#,#,#,.,#,#,#,.,#,.,#,#,#,.,#,.,#,#,#,#,#,.,#
#,.,.,.,.,.,.,.,.,.,.,.,#,.,.,.,#,.,#,.,.,.,.,.,.,.,.,.,.,.,#,.,.,.,#,.,#,.,.,.,.,.,.,.,#,.,.,.,.,.,#,.,#,.,.,.,#,.,#
#,.,#,#,#,#,#,#,#,#,#,.,#,#,#,#,#,#,#,#,#,#,#,.,#,#,#,#,#,#,#,#,#,.,.,.,.,#,#,.,#,#,#,#,#,#,#,#,.,.,#,.,#,.,#,.,#,.,#
#,.,.,.,#,.,.,.,.,.,.,.,#,.,.,.,.,.,.,.,.,.,#,.,#,.,.,.,.,.,.,.,.,.,#,.,.,.,.,.,.,.,.,.,.,.,.,.,#,.,#,.,#,.,#,.,.,.,#
#,#,#,.,#,.,.,#,#,#,#,.,#,.,.,#,#,#,#,#,#,.,.,.,.,.,.,#,#,#,#,#,#,#,#,#,#,#,#,#,#,#,#,#,#,#,#,.,#,#,#,.,#,.,#,#,#,#,#
#,.,.,.,.,.,#,.,.,.,.,.,#,.,#,.,.,.,#,.,.,.,#,.,#,.,.,.,.,.,.,.,.,.,#,.,.,.,.,.,.,.,.,.,.,.,#,.,.,.,#,.,#,.,#,.,.,.,#
#,.,#,.,#,.,#,.,#,#,#,#,#,.,#,.,.,.,#,.,#,#,#,.,#,#,#,#,#,#,#,.,#,.,#,.,#,#,#,.,#,.,#,.,#,.,#,#,#,.,#,.,#,.,#,#,#,.,#
#,.,#,.,.,.,#,.,.,.,.,.,.,.,#,.,.,.,#,.,.,.,#,.,.,.,#,.,.,.,.,.,.,.,#,.,.,.,#,.,.,.,#,.,#,.,.,.,.,.,#,.,#,.,.,.,.,.,#
#,.,#,#,#,#,#,#,#,#,#,.,#,.,#,#,#,.,#,#,.,.,#,#,#,.,#,.,#,#,#,.,#,#,#,#,#,#,#,.,#,.,#,.,#,#,#,#,#,#,#,.,#,.,#,.,#,.,#
#,.,.,.,.,.,.,.,.,.,#,.,#,.,.,.,#,.,.,.,.,.,.,.,.,.,.,.,#,.,.,.,#,.,.,.,.,.,#,.,#,.,#,.,.,.,#,.,.,.,.,.,.,.,#,.,#,.,#
#,.,#,#,#,.,#,.,#,#,#,.,#,.,#,.,#,#,#,#,.,#,#,#,#,#,#,#,#,.,#,.,#,.,#,#,#,.,#,#,#,.,#,#,#,.,#,#,#,.,#,#,#,.,#,.,.,#,#
#,.,#,.,#,.,#,.,.,.,.,.,#,.,#,.,.,.,.,.,.,.,#,.,#,.,.,.,.,.,#,.,#,.,#,.,#,.,.,.,.,.,.,.,#,.,.,.,#,.,#,.,#,.,#,.,.,.,#
#,.,#,.,#,.,#,#,#,.,#,#,#,.,#,.,.,.,.,#,#,.,#,.,#,.,#,#,#,.,#,.,#,.,#,.,#,#,#,.,#,#,#,.,#,#,#,.,#,.,#,.,#,.,#,#,#,.,#
#,.,#,.,#,.,.,.,#,.,#,.,.,.,#,.,.,.,.,.,#,.,#,.,#,.,#,.,#,.,#,.,.,.,.,.,.,.,#,.,.,.,#,.,#,.,#,.,.,.,#,.,#,.,.,.,.,.,#
#,.,#,.,#,#,#,.,#,.,#,.,#,#,#,#,#,#,#,#,#,.,#,.,#,.,#,.,#,.,#,.,#,#,#,.,#,.,#,.,#,.,#,.,#,.,#,#,#,#,#,.,#,.,#,#,.,.,#
#,.,.,.,.,.,#,.,.,.,#,.,.,.,.,.,#,.,.,.,.,.,#,.,.,.,.,.,#,.,#,.,.,.,#,.,#,.,.,.,#,.,#,.,.,.,.,.,.,.,.,.,.,.,#,.,.,.,#
#,#,#,.,#,.,.,#,#,#,#,#,#,#,.,.,#,.,#,#,#,.,#,#,#,#,#,.,#,.,#,.,#,.,#,.,#,.,#,#,.,.,#,#,#,.,#,#,#,#,#,.,#,.,#,.,#,#,#
#,.,.,.,#,.,.,.,#,.,.,.,.,.,.,.,#,.,#,.,#,.,#,.,.,.,.,.,#,.,#,.,#,.,#,.,#,.,.,.,.,.,.,.,#,.,#,.,.,.,.,.,#,.,#,.,#,.,#
#,.,#,.,#,#,#,.,#,.,#,.,#,#,#,.,#,.,.,.,#,.,#,.,#,#,#,.,#,.,#,.,#,.,#,.,#,.,#,#,#,#,#,#,#,.,#,.,#,#,#,#,#,.,.,.,#,.,#
#,.,#,.,#,.,.,.,#,.,#,.,.,.,.,.,.,.,#,.,.,.,#,.,.,.,#,.,#,.,.,.,#,.,.,.,#,.,.,.,.,.,#,.,.,.,#,.,#,.,#,.,.,.,#,.,#,.,#
#,.,#,#,#,.,#,#,.,.,#,#,#,.,.,#,#,#,#,#,#,#,#,#,#,.,#,.,#,.,#,.,#,#,#,#,#,.,#,#,#,.,#,.,#,#,#,.,#,.,#,.,#,.,#,.,#,.,#
#,.,.,.,.,.,#,.,.,.,.,.,.,.,.,.,.,.,.,.,.,.,.,.,.,.,#,.,#,.,#,.,#,.,.,.,#,.,#,.,.,.,.,.,#,.,#,.,.,.,#,.,#,.,#,.,#,.,#
#,.,#,#,#,#,#,#,#,#,#,#,#,#,#,#,.,#,#,#,#,#,#,#,#,#,#,.,#,.,#,.,#,.,#,.,#,#,#,.,#,#,#,.,#,.,#,.,#,#,#,.,#,.,#,.,#,.,#
#,.,.,.,.,.,.,.,#,.,.,.,.,.,#,.,.,.,.,.,.,.,.,.,.,.,.,.,#,.,#,.,.,.,.,.,.,.,#,.,.,.,.,.,.,.,#,.,#,.,.,.,#,.,#,.,#,.,#
#,#,.,#,#,#,#,.,#,.,.,#,#,.,#,.,#,#,#,#,#,#,#,#,#,#,#,#,#,.,#,#,#,#,#,#,#,.,#,#,#,#,#,#,#,#,#,.,#,.,#,#,#,.,#,.,#,.,#
#,.,.,.,.,.,#,.,#,.,#,.,#,.,.,.,#,.,#,.,.,.,.,.,.,.,#,.,.,.,.,.,.,.,.,.,#,.,.,.,.,.,.,.,.,.,#,.,#,.,#,.,.,.,#,.,#,.,#
#,.,#,.,#,.,#,.,#,.,.,.,#,#,#,.,#,.,#,.,#,#,#,.,#,.,#,.,#,#,#,#,.,.,#,.,#,#,.,.,#,.,#,#,#,.,#,.,#,.,#,#,#,#,#,.,#,.,#
#,.,#,.,#,.,#,.,#,.,#,.,.,.,.,.,.,.,#,.,#,.,.,.,#,.,#,.,.,.,.,.,#,.,#,.,.,.,#,.,.,.,#,.,.,.,#,.,#,.,.,.,.,.,#,.,#,.,#
#,#,#,.,#,.,#,.,#,.,#,.,#,#,#,#,#,#,#,.,#,.,#,.,#,#,#,#,#,#,#,.,#,.,#,#,#,.,#,#,#,#,#,.,#,#,#,.,#,#,#,#,#,.,#,.,#,.,#
#,.,.,.,#,.,#,.,.,.,#,.,.,.,.,.,.,.,.,.,#,.,#,.,.,.,.,.,.,.,#,.,#,.,.,.,#,.,.,.,.,.,#,.,.,.,.,.,#,.,.,.,.,.,#,.,.,.,#
#,.,#,#,#,.,#,#,#,#,#,.,#,.,#,#,#,#,#,#,#,.,#,.,#,#,#,.,#,.,#,.,#,#,#,#,#,#,#,.,#,.,#,#,#,#,#,#,#,.,#,.,#,.,#,.,#,.,#
#,.,#,.,.,.,.,.,.,.,#,.,.,.,.,.,#,.,.,.,#,.,#,.,.,.,.,.,#,.,#,.,.,.,.,.,.,.,#,.,.,.,.,.,.,.,.,.,.,.,#,.,#,.,#,.,#,.,#
#,.,#,#,#,#,#,#,#,.,#,#,#,.,#,.,#,.,.,.,#,.,#,.,#,.,#,.,#,#,#,#,#,#,#,#,#,.,#,.,#,.,#,.,#,.,#,#,.,#,#,.,#,.,#,.,#,.,#
#,.,.,.,#,.,.,.,#,.,.,.,#,.,.,.,.,.,#,.,.,.,#,.,.,.,.,.,.,.,.,.,.,.,.,.,#,.,#,.,#,.,.,.,#,.,.,.,.,.,#,.,#,.,.,.,#,.,#
#,.,#,.,#,.,#,#,#,#,#,.,#,#,#,#,#,#,#,.,#,.,.,.,#,.,#,#,#,.,#,#,#,#,#,.,#,.,#,#,#,#,#,.,#,#,#,#,#,.,#,.,#,#,#,#,#,.,#
#,.,#,.,#,.,.,.,.,.,#,.,#,.,.,.,.,.,.,.,#,.,#,.,.,.,#,.,.,.,#,.,.,.,.,.,#,.,.,.,.,.,.,.,#,.,#,.,.,.,#,.,.,.,.,.,.,.,#
#,.,#,.,#,.,#,.,#,#,#,.,#,.,#,#,#,#,#,#,.,.,#,.,#,.,#,.,#,#,#,#,#,#,.,#,#,#,#,#,#,#,.,.,.,.,.,.,.,#,#,.,#,#,#,.,#,#,#
#,.,#,.,#,.,#,.,.,.,.,.,.,.,#,.,.,.,#,.,.,.,#,.,.,.,#,.,.,.,.,.,.,.,.,.,.,.,.,.,.,.,.,.,.,.,.,.,#,.,#,.,#,.,#,.,.,.,#
#,.,#,.,#,#,#,.,#,#,#,#,#,.,#,.,#,.,#,#,#,#,#,#,#,.,#,#,#,.,#,.,#,#,#,#,#,.,#,#,#,.,#,#,#,#,#,#,#,.,#,.,#,.,.,#,.,.,#
#,.,#,.,.,.,#,.,.,.,.,.,#,.,.,.,#,.,.,.,.,.,.,.,#,.,.,.,#,.,.,.,.,.,#,.,.,.,#,.,.,.,#,.,.,.,.,.,#,.,.,.,#,.,.,.,#,.,#
#,.,#,.,#,.,.,.,#,.,#,#,#,.,#,#,#,#,#,#,#,#,#,.,#,.,#,.,#,.,#,.,#,#,#,.,#,.,.,.,#,#,#,#,.,.,.,.,.,#,#,.,.,.,#,.,#,.,#
#,.,#,.,#,.,#,.,#,.,.,.,#,.,.,.,#,.,.,.,.,.,.,.,.,.,#,.,#,.,#,.,#,.,.,.,#,.,#,.,#,.,.,.,.,.,#,.,.,.,#,.,.,.,.,.,.,.,#
#,.,#,.,#,.,#,#,#,.,#,.,#,.,#,.,#,.,.,.,.,.,#,#,.,.,.,.,#,.,#,.,#,.,.,.,#,#,.,.,#,.,#,.,#,#,#,#,.,.,#,#,#,#,#,#,#,.,#
#,.,.,.,#,.,.,.,.,.,#,.,.,.,.,.,.,.,.,.,#,.,.,.,#,.,.,.,#,.,.,.,#,.,#,.,#,.,.,.,#,.,#,.,.,.,.,.,#,.,.,.,#,.,.,.,#,.,#
#,#,#,.,#,#,#,#,#,.,.,.,#,#,.,.,#,#,#,#,#,#,#,#,#,#,#,#,#,.,#,#,#,.,#,.,#,.,#,#,#,#,#,#,#,.,#,.,#,#,#,.,#,.,#,.,#,.,#
#,.,.,.,#,.,.,.,#,.,.,.,.,.,.,.,#,.,.,.,.,.,.,.,#,.,.,.,#,.,.,.,#,.,#,.,#,.,.,.,#,.,.,.,.,.,#,.,#,.,#,.,.,.,#,.,.,.,#
#,#,#,#,#,.,#,.,#,#,#,#,#,.,#,#,#,.,#,#,#,.,#,.,#,.,#,.,#,#,#,#,#,.,#,.,#,#,#,.,#,.,#,.,#,.,#,.,.,.,.,#,#,#,#,#,#,.,#
#,.,.,.,.,.,#,.,.,.,.,.,.,.,.,.,.,.,#,.,.,.,.,.,.,.,#,.,#,.,.,.,.,.,#,.,.,.,#,.,#,.,#,.,#,.,#,.,#,.,.,.,.,.,#,.,.,.,#
#,.,#,.,#,#,#,#,#,#,#,.,#,#,#,#,#,#,#,#,.,#,#,#,#,#,#,.,#,.,.,#,#,.,#,#,#,.,#,.,#,.,#,.,#,#,#,.,#,.,#,#,#,.,#,.,#,#,#
#,.,#,.,.,.,.,.,.,.,.,.,.,.,#,.,.,.,#,.,.,.,.,.,.,.,#,.,.,.,#,.,.,.,#,.,.,.,#,.,.,.,#,.,.,.,#,.,#,.,.,.,#,.,#,.,#,.,#
#,.,#,.,#,.,#,.,#,#,#,#,#,.,#,.,#,.,#,.,#,#,.,#,#,.,#,#,#,#,#,.,#,.,#,#,#,#,#,#,#,#,#,#,#,.,#,.,#,.,#,.,#,#,.,.,#,.,#
#,.,.,.,#,.,.,.,.,.,.,.,#,.,.,.,#,.,.,.,.,.,.,.,#,.,.,.,.,.,.,.,#,.,.,.,.,.,.,.,.,.,.,.,.,.,.,.,#,.,#,.,.,.,.,.,.,G,#
#,#,#,#,#,#,#,#,#,#,#,#,#,#,#,#,#,#,#,#,#,#,#,#,#,#,#,#,#,#,#,#,#,#,#,#,#,#,#,#,#,#,#,#,#,#,#,#,#,#,#,#,#,#,#,#,#,#,#
